AAAAAAAACAT -> AAAAAAACATC
AAAAAAACATC -> AAAAAACATCT
AAAAAACATCT -> AAAAACATCTA
AAAAACATCTA -> AAAACATCTAC
AAAAATGAACC -> AAAATGAACCT
AAAACAGTAAA -> AAACAGTAAAT
AAAACATCTAC -> AAACATCTACA
AAAACTGTCCT -> AAACTGTCCTG
AAAAGAGGAAC -> AAAGAGGAACC
AAAATACGCCA -> AAATACGCCAA
AAAATGAACCT -> AAATGAACCTT
AAACAGTAAAT -> AACAGTAAATA
AAACATCTACA -> AACATCTACAA
AAACCTCACTT -> AACCTCACTTA
AAACTCAGATC -> AACTCAGATCG
AAACTGTCCTG -> AACTGTCCTGA
AAAGAATCTAC -> AAGAATCTACT
AAAGAGGAACC -> AAGAGGAACCC
AAAGAGGTAAA -> AAGAGGTAAAT
AAAGCGGCGAG -> AAGCGGCGAGT
AAAGGATGTCA -> AAGGATGTCAA
AAAGTCTACCC -> AAGTCTACCCC
AAATACGCCAA -> AATACGCCAAC
AAATAGGGGCC -> AATAGGGGCCC
AAATATCAGTT -> AATATCAGTTA
AAATATTGAGA -> AATATTGAGAT
AAATCTCCGCA -> AATCTCCGCAA
AAATGAACCTT -> AATGAACCTTG
AAATGAGAAAA -> AATGAGAAAAA
AAATGTACGAG -> AATGTACGAGG
AAATTCCAACG -> AATTCCAACGA
AACACAAATCT -> ACACAAATCTC
AACACGAGGGC -> ACACGAGGGCG
AACACGGCCGG -> ACACGGCCGGA
AACACGGTACA -> ACACGGTACAA
AACAGGCCATA -> ACAGGCCATAT
AACAGGTGGGT -> ACAGGTGGGTG
AACAGTAAATA -> ACAGTAAATAT
AACATCGACTT -> ACATCGACTTG
AACATCTACAA -> ACATCTACAAG
AACCAACGTCG -> ACCAACGTCGC
AACCAGTCTGG -> ACCAGTCTGGG
AACCCGACTGA -> ACCCGACTGAG
AACCCGGATTG -> ACCCGGATTGT
AACCCGTTAGC -> ACCCGTTAGCC
AACCGCATGCG -> ACCGCATGCGG
AACCTAATCAG -> ACCTAATCAGA
AACCTCACTTA -> ACCTCACTTAA
AACCTGGTCAG -> ACCTGGTCAGG
AACCTTGACAG -> ACCTTGACAGA
AACCTTGGAGA -> ACCTTGGAGAA
AACGACGGTTC -> ACGACGGTTCA
AACGATCGGGC -> ACGATCGGGCA
AACGATGATCA -> ACGATGATCAT
AACGGAACACG -> ACGGAACACGG
AACGTCCTAGA -> ACGTCCTAGAC
AACGTCGCTGT -> ACGTCGCTGTG
AACGTCTGTGT -> ACGTCTGTGTG
AACTAGAATCC -> ACTAGAATCCC
AACTATATGCC -> ACTATATGCCT
AACTCACACTC -> ACTCACACTCA
AACTCAGATCG -> ACTCAGATCGG
AACTCGTCACC -> ACTCGTCACCG
AACTGAACACG -> ACTGAACACGG
AACTGCTCCCA -> ACTGCTCCCAG
AACTGTCCTGA -> ACTGTCCTGAC
AACTTTGGTGC -> ACTTTGGTGCG
AAGAATCTACT -> AGAATCTACTG
AAGAGCAGATT -> AGAGCAGATTG
AAGAGGAACCC -> AGAGGAACCCG
AAGAGGTAAAT -> AGAGGTAAATG
AAGAGTTCTGC -> AGAGTTCTGCA
AAGATCCAAAT -> AGATCCAAATG
AAGATCTATGA -> AGATCTATGAA
AAGATGGACAA -> AGATGGACAAT
AAGATGTACAT -> AGATGTACATG
AAGCACGTTTG -> AGCACGTTTGG
AAGCATCTTCT -> AGCATCTTCTT
AAGCGGCGAGT -> AGCGGCGAGTC
AAGCGTAGACG -> AGCGTAGACGC
AAGCTACGGCT -> AGCTACGGCTA
AAGGACAGACT -> AGGACAGACTC
AAGGACCCAGA -> AGGACCCAGAG
AAGGATGTCAA -> AGGATGTCAAT
AAGGCACGGTC -> AGGCACGGTCG
AAGGGAGAGAA -> AGGGAGAGAAC
AAGGGCCGTAC -> AGGGCCGTACG
AAGGTAAGGGC -> AGGTAAGGGCC
AAGGTCACGGT -> AGGTCACGGTC
AAGTCGATAGT -> AGTCGATAGTA
AAGTCTACCCC -> AGTCTACCCCG
AAGTGCATCAG -> AGTGCATCAGA
AAGTTAATCAA -> AGTTAATCAAG
AATACGCCAAC -> ATACGCCAACG
AATACTAGCAC -> ATACTAGCACG
AATACTGTGGA -> ATACTGTGGAG
AATAGACCCCG -> ATAGACCCCGT
AATAGGGGCCC -> ATAGGGGCCCG
AATATCAGTTA -> ATATCAGTTAA
AATATCGCGAA -> ATATCGCGAAG
AATATTGAGAT -> ATATTGAGATT
AATCAAAAATG -> ATCAAAAATGA
AATCAAGATGT -> ATCAAGATGTA
AATCAGACTTA -> ATCAGACTTAT
AATCAGCCGCC -> ATCAGCCGCCA
AATCCCATAAC -> ATCCCATAACA
AATCCCGGAGT -> ATCCCGGAGTC
AATCCCTTCAC -> ATCCCTTCACA
AATCGAGGCGC -> ATCGAGGCGCA
AATCGCGCAGC -> ATCGCGCAGCC
AATCTACTGGA -> ATCTACTGGAT
AATCTATTCAG -> ATCTATTCAGC
AATCTCCGCAA -> ATCTCCGCAAT
AATGAACCTTG -> ATGAACCTTGA
AATGAGAAAAA -> ATGAGAAAAAA
AATGATATGTT -> ATGATATGTTA
AATGATGATGT -> ATGATGATGTT
AATGATTCGAG -> ATGATTCGAGA
AATGCGGGGAG -> ATGCGGGGAGG
AATGTACGAGG -> ATGTACGAGGT
AATGTATAACT -> ATGTATAACTA
AATGTCCTGAG -> ATGTCCTGAGT
AATTCACTTGA -> ATTCACTTGAC
AATTCCAACGA -> ATTCCAACGAT
AATTGAATGAT -> ATTGAATGATG
AATTGAGTCGT -> ATTGAGTCGTG
AATTTCTCTTC -> ATTTCTCTTCA
AATTTGTGAGC -> ATTTGTGAGCC
ACAAAATACGC -> CAAAATACGCC
ACAAATCTCCG -> CAAATCTCCGC
ACAAGATCTAT -> CAAGATCTATG
ACAAGCACGTT -> CAAGCACGTTT
ACAAGCATCTT -> CAAGCATCTTC
ACAATACTGTG -> CAATACTGTGG
ACAATTTCTCT -> CAATTTCTCTT
ACACAAATCTC -> CACAAATCTCC
ACACACGCAGC -> CACACGCAGCA
ACACACGCCTG -> CACACGCCTGG
ACACAGCCAGG -> CACAGCCAGGC
ACACAGTTCGT -> CACAGTTCGTG
ACACCATAGGC -> CACCATAGGCT
ACACGAGGGCG -> CACGAGGGCGA
ACACGCAGCAT -> CACGCAGCATT
ACACGCCTGGG -> CACGCCTGGGC
ACACGGCCGGA -> CACGGCCGGAA
ACACGGTACAA -> CACGGTACAAG
ACACGGTGCCT -> CACGGTGCCTG
ACACGTGCGAG -> CACGTGCGAGT
ACACTCAGCAA -> CACTCAGCAAT
ACACTCTTCTA -> CACTCTTCTAA
ACAGACTCGTG -> CAGACTCGTGG
ACAGACTTAAC -> CAGACTTAACG
ACAGCCAGGCC -> CAGCCAGGCCT
ACAGGCAGACC -> CAGGCAGACCA
ACAGGCCATAT -> CAGGCCATATA
ACAGGCCTTTC -> CAGGCCTTTCC
ACAGGTGGGTG -> CAGGTGGGTGC
ACAGTAAATAT -> CAGTAAATATC
ACAGTCTCTAT -> CAGTCTCTATA
ACAGTTCGTGA -> CAGTTCGTGAC
ACATAATTGAA -> CATAATTGAAT
ACATAGTGTAT -> CATAGTGTATC
ACATCAAAGGA -> CATCAAAGGAT
ACATCGACTTG -> CATCGACTTGC
ACATCTACAAG -> CATCTACAAGC
ACATGCCAACC -> CATGCCAACCC
ACATTTTATGG -> CATTTTATGGG
ACCAACGTCGC -> CCAACGTCGCT
ACCAATCGAGG -> CCAATCGAGGC
ACCACTGTGTC -> CCACTGTGTCC
ACCAGTACAGG -> CCAGTACAGGC
ACCAGTCTGGG -> CCAGTCTGGGG
ACCATAGGCTT -> CCATAGGCTTT
ACCATGTGAAC -> CCATGTGAACC
ACCCAGAGTCA -> CCCAGAGTCAT
ACCCATTTAAT -> CCCATTTAATA
ACCCCAAGGGA -> CCCCAAGGGAG
ACCCCGCAGTT -> CCCCGCAGTTG
ACCCCGGCTAC -> CCCCGGCTACC
ACCCCGTTGCA -> CCCCGTTGCAT
ACCCGACTGAG -> CCCGACTGAGC
ACCCGGATTGT -> CCCGGATTGTA
ACCCGGTTCCA -> CCCGGTTCCAA
ACCCGTGGCGT -> CCCGTGGCGTA
ACCCGTTAGCC -> CCCGTTAGCCT
ACCCTCTCATT -> CCCTCTCATTA
ACCGCATGCGG -> CCGCATGCGGC
ACCGGCACACT -> CCGGCACACTC
ACCGGTCAGTG -> CCGGTCAGTGA
ACCGTGTCAAC -> CCGTGTCAACC
ACCTAATCAGA -> CCTAATCAGAC
ACCTACGCCCC -> CCTACGCCCCA
ACCTAGTCCGA -> CCTAGTCCGAA
ACCTCACTTAA -> CCTCACTTAAA
ACCTGAGCTGC -> CCTGAGCTGCT
ACCTGGTCAGG -> CCTGGTCAGGT
ACCTTGACAGA -> CCTTGACAGAC
ACCTTGGAGAA -> CCTTGGAGAAG
ACGACACACGC -> CGACACACGCA
ACGACCTAGTC -> CGACCTAGTCC
ACGACGGTTCA -> CGACGGTTCAC
ACGACGTCCTA -> CGACGTCCTAT
ACGAGGGCGAA -> CGAGGGCGAAT
ACGAGGTGGTG -> CGAGGTGGTGA
ACGATCGGGCA -> CGATCGGGCAT
ACGATGATCAT -> CGATGATCATG
ACGCAGCATTA -> CGCAGCATTAA
ACGCCAACGTC -> CGCCAACGTCC
ACGCCCCATGT -> CGCCCCATGTC
ACGCCCGAGAC -> CGCCCGAGACG
ACGCCTGGGCA -> CGCCTGGGCAT
ACGCCTTAACC -> CGCCTTAACCA
ACGCGCGTACC -> CGCGCGTACCC
ACGGAACACGG -> CGGAACACGGT
ACGGAGATATC -> CGGAGATATCC
ACGGAGTAACA -> CGGAGTAACAC
ACGGCCGAAGG -> CGGCCGAAGGT
ACGGCCGGAAC -> CGGCCGGAACC
ACGGCTAAGAG -> CGGCTAAGAGT
ACGGGGCCTCA -> CGGGGCCTCAT
ACGGGGTCCAC -> CGGGGTCCACA
ACGGTACAAGC -> CGGTACAAGCA
ACGGTCGTTGC -> CGGTCGTTGCC
ACGGTCTTGAG -> CGGTCTTGAGA
ACGGTGCCTGC -> CGGTGCCTGCC
ACGGTTCACGT -> CGGTTCACGTA
ACGTAACCAAC -> CGTAACCAACG
ACGTAGGACGA -> CGTAGGACGAC
ACGTATTTCCG -> CGTATTTCCGC
ACGTCCAGAGG -> CGTCCAGAGGG
ACGTCCTAGAC -> CGTCCTAGACT
ACGTCCTATAA -> CGTCCTATAAC
ACGTCGCTGTG -> CGTCGCTGTGT
ACGTCTGTGTG -> CGTCTGTGTGT
ACGTGCGAGTC -> CGTGCGAGTCG
ACGTGGTGCCT -> CGTGGTGCCTG
ACGTGTGCCTC -> CGTGTGCCTCA
ACGTTCACTCA -> CGTTCACTCAC
ACGTTTGGCTC -> CGTTTGGCTCC
ACTAGAATCCC -> CTAGAATCCCG
ACTAGCACGCC -> CTAGCACGCCC
ACTATATGCCT -> CTATATGCCTG
ACTCAACATCG -> CTCAACATCGA
ACTCACACACG -> CTCACACACGC
ACTCACACTCA -> CTCACACTCAG
ACTCAGATCGG -> CTCAGATCGGC
ACTCAGCAATG -> CTCAGCAATGT
ACTCGATTCAA -> CTCGATTCAAA
ACTCGTCACCG -> CTCGTCACCGG
ACTCGTGGGTC -> CTCGTGGGTCA
ACTCTTCTAAA -> CTCTTCTAAAT
ACTGAACACGG -> CTGAACACGGC
ACTGAGCCATC -> CTGAGCCATCA
ACTGCTCCCAG -> CTGCTCCCAGT
ACTGGATCATG -> CTGGATCATGG
ACTGGTGTTGT -> CTGGTGTTGTC
ACTGTCACACG -> CTGTCACACGG
ACTGTCCTGAC -> CTGTCCTGACC
ACTGTGGAGCA -> CTGTGGAGCAT
ACTGTGTCCTG -> CTGTGTCCTGA
ACTTAAAGCGG -> CTTAAAGCGGC
ACTTAACGTCT -> CTTAACGTCTG
ACTTATAGACC -> CTTATAGACCA
ACTTGACGTGG -> CTTGACGTGGT
ACTTGCTAATC -> CTTGCTAATCT
ACTTGTGTTGG -> CTTGTGTTGGG
ACTTTGGTGCG -> CTTTGGTGCGA
AGAAAAAAAAC -> GAAAAAAAACA
AGAACAGGCCA -> GAACAGGCCAT
AGAACCGCATG -> GAACCGCATGC
AGAAGGACAGA -> GAAGGACAGAC
AGAATCCCGGA -> GAATCCCGGAG
AGAATCGCGCA -> GAATCGCGCAG
AGAATCTACTG -> GAATCTACTGG
AGACACAGTTC -> GACACAGTTCG
AGACCAATCGA -> GACCAATCGAG
AGACCACTGTG -> GACCACTGTGT
AGACCCCGTTG -> GACCCCGTTGC
AGACGACCTAG -> GACGACCTAGT
AGACGACGTCC -> GACGACGTCCT
AGACGCCTTAA -> GACGCCTTAAC
AGACGGCCGAA -> GACGGCCGAAG
AGACTCAACAT -> GACTCAACATC
AGACTCGTGGG -> GACTCGTGGGT
AGACTTAACGT -> GACTTAACGTC
AGACTTATAGA -> GACTTATAGAC
AGACTTGTGTT -> GACTTGTGTTG
AGAGAACAGGC -> GAGAACAGGCC
AGAGACGACGT -> GAGACGACGTC
AGAGCAGATTG -> GAGCAGATTGA
AGAGCGAATTC -> GAGCGAATTCA
AGAGGAACCCG -> GAGGAACCCGT
AGAGGGAGGAT -> GAGGGAGGATG
AGAGGTAAATG -> GAGGTAAATGT
AGAGTACGTGT -> GAGTACGTGTG
AGAGTCATCGC -> GAGTCATCGCG
AGAGTGAGAGT -> GAGTGAGAGTT
AGAGTTCTGCA -> GAGTTCTGCAA
AGAGTTTCAAA -> GAGTTTCAAAT
AGATATCCTTG -> GATATCCTTGA
AGATCCAAATG -> GATCCAAATGA
AGATCGGCTCA -> GATCGGCTCAC
AGATCTATGAA -> GATCTATGAAC
AGATGGACAAT -> GATGGACAATT
AGATGTACATG -> GATGTACATGC
AGATTGAGCGG -> GATTGAGCGGC
AGATTGGTCTC -> GATTGGTCTCA
AGCAATCAGCC -> GCAATCAGCCG
AGCAATGTATA -> GCAATGTATAA
AGCACGCCCGA -> GCACGCCCGAG
AGCACGTTTGG -> GCACGTTTGGC
AGCAGATTGAG -> GCAGATTGAGC
AGCATCTTCTT -> GCATCTTCTTT
AGCATTAAAGA -> GCATTAAAGAA
AGCATTCGCAG -> GCATTCGCAGG
AGCCAGGCCTC -> GCCAGGCCTCG
AGCCATCAATC -> GCCATCAATCT
AGCCGCCAGGT -> GCCGCCAGGTC
AGCCGTCGTCT -> GCCGTCGTCTC
AGCCTACCCGG -> GCCTACCCGGT
AGCCTCATCAG -> GCCTCATCAGT
AGCCTCTTATC -> GCCTCTTATCA
AGCGAATTCAC -> GCGAATTCACT
AGCGGCCACCA -> GCGGCCACCAT
AGCGGCGAGTC -> GCGGCGAGTCA
AGCGGTCTCAC -> GCGGTCTCACG
AGCGGTTAAGA -> GCGGTTAAGAT
AGCGTAGACGC -> GCGTAGACGCC
AGCTACGGCTA -> GCTACGGCTAA
AGCTGCTAATA -> GCTGCTAATAG
AGCTTAAATAG -> GCTTAAATAGG
AGCTTTCCACG -> GCTTTCCACGT
AGGAACCCGTT -> GGAACCCGTTA
AGGACAGACTC -> GGACAGACTCG
AGGACCCAGAG -> GGACCCAGAGT
AGGACGACACA -> GGACGACACAC
AGGATCGAGAA -> GGATCGAGAAT
AGGATGGCTCG -> GGATGGCTCGC
AGGATGTCAAT -> GGATGTCAATG
AGGCAAAGTCT -> GGCAAAGTCTA
AGGCACGGTCG -> GGCACGGTCGT
AGGCAGACCAA -> GGCAGACCAAT
AGGCCATATAT -> GGCCATATATT
AGGCCTCGTAA -> GGCCTCGTAAC
AGGCCTTTCCG -> GGCCTTTCCGG
AGGCGCAACGA -> GGCGCAACGAT
AGGCTAATTTG -> GGCTAATTTGT
AGGCTTTATAC -> GGCTTTATACC
AGGGAGAGAAC -> GGGAGAGAACA
AGGGAGGATGG -> GGGAGGATGGC
AGGGCCGTACG -> GGGCCGTACGG
AGGGCGAATGA -> GGGCGAATGAT
AGGGGATCACA -> GGGGATCACAT
AGGGGCAGTTA -> GGGGCAGTTAC
AGGGGCCCGAC -> GGGGCCCGACG
AGGTAAATGTA -> GGTAAATGTAC
AGGTAAGGGCC -> GGTAAGGGCCG
AGGTCAAGGTA -> GGTCAAGGTAA
AGGTCACGGTC -> GGTCACGGTCT
AGGTCCAAGTC -> GGTCCAAGTCG
AGGTGGGTGCT -> GGTGGGTGCTG
AGGTGGTGAGC -> GGTGGTGAGCG
AGTAAATATCA -> GTAAATATCAG
AGTAACACGAG -> GTAACACGAGG
AGTACACGTGC -> GTACACGTGCG
AGTACAGGCAG -> GTACAGGCAGA
AGTACGTGTGC -> GTACGTGTGCC
AGTCAAGGCAC -> GTCAAGGCACG
AGTCACTGGTG -> GTCACTGGTGT
AGTCATCGCGA -> GTCATCGCGAA
AGTCATTGAGC -> GTCATTGAGCA
AGTCCGAATCC -> GTCCGAATCCC
AGTCGAATCAA -> GTCGAATCAAA
AGTCGATAGTA -> GTCGATAGTAC
AGTCGTCGGAA -> GTCGTCGGAAA
AGTCGTGTCCG -> GTCGTGTCCGG
AGTCTACCCCG -> GTCTACCCCGG
AGTCTCTATAC -> GTCTCTATACC
AGTCTGGGGAA -> GTCTGGGGAAT
AGTGACCTGAG -> GTGACCTGAGC
AGTGAGAGTTT -> GTGAGAGTTTC
AGTGCATCAGA -> GTGCATCAGAG
AGTGTATCGCC -> GTGTATCGCCT
AGTTAAGAGCA -> GTTAAGAGCAG
AGTTAATCAAG -> GTTAATCAAGA
AGTTACAAAAT -> GTTACAAAATA
AGTTCGTGACG -> GTTCGTGACGG
AGTTCTGCAAC -> GTTCTGCAACG
AGTTCTTACAT -> GTTCTTACATC
AGTTGAATTGA -> GTTGAATTGAG
AGTTGACTCGA -> GTTGACTCGAT
AGTTGGGCCTT -> GTTGGGCCTTA
AGTTGGTCTGG -> GTTGGTCTGGT
AGTTTCAAATT -> GTTTCAAATTC
ATAAAACAGTA -> TAAAACAGTAA
ATAACACAAAT -> TAACACAAATC
ATAACTATATG -> TAACTATATGC
ATAACTCACAC -> TAACTCACACT
ATAAGCTACGG -> TAAGCTACGGC
ATAATTGAATG -> TAATTGAATGA
ATACCGGCACA -> TACCGGCACAC
ATACCGTGTCA -> TACCGTGTCAA
ATACGCCAACG -> TACGCCAACGT
ATACGTATTTC -> TACGTATTTCC
ATACTAGCACG -> TACTAGCACGC
ATACTGTGGAG -> TACTGTGGAGC
ATAGACCACTG -> TAGACCACTGT
ATAGACCCCGT -> TAGACCCCGTT
ATAGGCTTTAT -> TAGGCTTTATA
ATAGGGGCCCG -> TAGGGGCCCGA
ATAGTACACGT -> TAGTACACGTG
ATAGTGTATCG -> TAGTGTATCGC
ATATATTTGTG -> TATATTTGTGG
ATATCAGTTAA -> TATCAGTTAAG
ATATCCTTGAC -> TATCCTTGACC
ATATCGCACGT -> TATCGCACGTA
ATATCGCGAAG -> TATCGCGAAGC
ATATGCCTGAG -> TATGCCTGAGA
ATATGTTAAGA -> TATGTTAAGAT
ATATTGAGATT -> TATTGAGATTG
ATATTTGTGGA -> TATTTGTGGAT
ATCAAAAATGA -> TCAAAAATGAA
ATCAAAGGATG -> TCAAAGGATGT
ATCAACTCGTC -> TCAACTCGTCA
ATCAAGATGTA -> TCAAGATGTAC
ATCAATCTCAC -> TCAATCTCACT
ATCACATTTTA -> TCACATTTTAT
ATCAGACTTAT -> TCAGACTTATA
ATCAGAGTGAG -> TCAGAGTGAGA
ATCAGCCGCCA -> TCAGCCGCCAG
ATCAGTTAAGA -> TCAGTTAAGAG
ATCAGTTCTTA -> TCAGTTCTTAC
ATCATGATCTA -> TCATGATCTAT
ATCATGGTAAG -> TCATGGTAAGG
ATCCAAATGAG -> TCCAAATGAGA
ATCCCATAACA -> TCCCATAACAC
ATCCCGGAGTC -> TCCCGGAGTCG
ATCCCTTCACA -> TCCCTTCACAG
ATCCTTGACCA -> TCCTTGACCAG
ATCGACTTGCT -> TCGACTTGCTA
ATCGAGAATCG -> TCGAGAATCGC
ATCGAGGCGCA -> TCGAGGCGCAA
ATCGCACGTAA -> TCGCACGTAAC
ATCGCCTGAGT -> TCGCCTGAGTT
ATCGCGAACTT -> TCGCGAACTTT
ATCGCGAAGCG -> TCGCGAAGCGT
ATCGCGCAGCC -> TCGCGCAGCCT
ATCGGCTCACA -> TCGGCTCACAG
ATCGGGCATAA -> TCGGGCATAAA
ATCTACAAGCA -> TCTACAAGCAC
ATCTACTGGAT -> TCTACTGGATC
ATCTATGAACA -> TCTATGAACAG
ATCTATTAACT -> TCTATTAACTA
ATCTATTCAGC -> TCTATTCAGCT
ATCTCCAGTTG -> TCTCCAGTTGA
ATCTCCGCAAT -> TCTCCGCAATG
ATCTGACAAGA -> TCTGACAAGAT
ATCTGGGGAAC -> TCTGGGGAACT
ATCTTCTTTGA -> TCTTCTTTGAG
ATGAACAGGTG -> TGAACAGGTGG
ATGAACCTTGA -> TGAACCTTGAC
ATGACGGGGCC -> TGACGGGGCCT
ATGAGAAAAAA -> TGAGAAAAAAA
ATGATATGTTA -> TGATATGTTAA
ATGATCATGAT -> TGATCATGATC
ATGATCTATTA -> TGATCTATTAA
ATGATGATGTT -> TGATGATGTTG
ATGATGTTGTG -> TGATGTTGTGG
ATGATTCGAGA -> TGATTCGAGAC
ATGCCAACCCG -> TGCCAACCCGA
ATGCCTGAGAG -> TGCCTGAGAGC
ATGCGGCATTT -> TGCGGCATTTC
ATGCGGCGCGC -> TGCGGCGCGCA
ATGCGGGGAGG -> TGCGGGGAGGC
ATGGACAATTT -> TGGACAATTTC
ATGGCTCGCCA -> TGGCTCGCCAG
ATGGGAGACGG -> TGGGAGACGGC
ATGGTAAGGAC -> TGGTAAGGACC
ATGGTCAGAAC -> TGGTCAGAACC
ATGTACATGCC -> TGTACATGCCA
ATGTACGAGGT -> TGTACGAGGTG
ATGTATAACTA -> TGTATAACTAT
ATGTCAATGCG -> TGTCAATGCGG
ATGTCCTCCAA -> TGTCCTCCAAC
ATGTCCTGAGT -> TGTCCTGAGTC
ATGTGAACCTT -> TGTGAACCTTG
ATGTTAAGATG -> TGTTAAGATGG
ATGTTGTGGTA -> TGTTGTGGTAA
ATTAAAGAATC -> TTAAAGAATCT
ATTAACTAGAA -> TTAACTAGAAT
ATTAATGTCCT -> TTAATGTCCTG
ATTACCCCGCA -> TTACCCCGCAG
ATTCAAACTCA -> TTCAAACTCAG
ATTCACTGTCA -> TTCACTGTCAC
ATTCACTTGAC -> TTCACTTGACG
ATTCAGCTTTC -> TTCAGCTTTCC
ATTCCAACGAT -> TTCCAACGATC
ATTCGAGACAC -> TTCGAGACACA
ATTCGCAAAGA -> TTCGCAAAGAG
ATTCGCAGGCT -> TTCGCAGGCTA
ATTGAATGATG -> TTGAATGATGA
ATTGAGATTGG -> TTGAGATTGGT
ATTGAGCAATC -> TTGAGCAATCA
ATTGAGCGGCC -> TTGAGCGGCCA
ATTGAGTCGTG -> TTGAGTCGTGT
ATTGGAAGTTA -> TTGGAAGTTAA
ATTGGTCTCAC -> TTGGTCTCACA
ATTGTACGCGC -> TTGTACGCGCG
ATTTAATACTA -> TTTAATACTAG
ATTTAGAGACG -> TTTAGAGACGA
ATTTCCGCACA -> TTTCCGCACAT
ATTTCGTTGTG -> TTTCGTTGTGA
ATTTCTCTTCA -> TTTCTCTTCAT
ATTTGTGAGCC -> TTTGTGAGCCG
ATTTGTGGATA -> TTTGTGGATAT
ATTTTATGGGA -> TTTTATGGGAG
CAAAAATGAAC -> AAAAATGAACC
CAAAAGAGGAA -> AAAAGAGGAAC
CAAAATACGCC -> AAAATACGCCA
CAAACCTCACT -> AAACCTCACTT
CAAACTCAGAT -> AAACTCAGATC
CAAAGAGGTAA -> AAAGAGGTAAA
CAAAGGATGTC -> AAAGGATGTCA
CAAAGTCTACC -> AAAGTCTACCC
CAAATCTCCGC -> AAATCTCCGCA
CAAATGAGAAA -> AAATGAGAAAA
CAAATTCCAAC -> AAATTCCAACG
CAACATCGACT -> AACATCGACTT
CAACCCGACTG -> AACCCGACTGA
CAACCTAATCA -> AACCTAATCAG
CAACGACGGTT -> AACGACGGTTC
CAACGATCGGG -> AACGATCGGGC
CAACGATGATC -> AACGATGATCA
CAACGGAACAC -> AACGGAACACG
CAACGTCCTAG -> AACGTCCTAGA
CAACGTCGCTG -> AACGTCGCTGT
CAACTCGTCAC -> AACTCGTCACC
CAAGATCTATG -> AAGATCTATGA
CAAGATGTACA -> AAGATGTACAT
CAAGCACGTTT -> AAGCACGTTTG
CAAGCATCTTC -> AAGCATCTTCT
CAAGGCACGGT -> AAGGCACGGTC
CAAGGGAGAGA -> AAGGGAGAGAA
CAAGGTAAGGG -> AAGGTAAGGGC
CAAGTCGATAG -> AAGTCGATAGT
CAAGTGCATCA -> AAGTGCATCAG
CAATACTGTGG -> AATACTGTGGA
CAATCAGCCGC -> AATCAGCCGCC
CAATCGAGGCG -> AATCGAGGCGC
CAATCTCACTC -> AATCTCACTCC
CAATGATATGT -> AATGATATGTT
CAATGCGGGGA -> AATGCGGGGAG
CAATGTATAAC -> AATGTATAACT
CAATTTCTCTT -> AATTTCTCTTC
CACAAATCTCC -> ACAAATCTCCG
CACACACGCCT -> ACACACGCCTG
CACACAGCCAG -> ACACAGCCAGG
CACACCATAGG -> ACACCATAGGC
CACACGCAGCA -> ACACGCAGCAT
CACACGCCTGG -> ACACGCCTGGG
CACACGGTGCC -> ACACGGTGCCT
CACACTCAGCA -> ACACTCAGCAA
CACACTCTTCT -> ACACTCTTCTA
CACAGCCAGGC -> ACAGCCAGGCC
CACAGGCCTTT -> ACAGGCCTTTC
CACAGTCTCTA -> ACAGTCTCTAT
CACAGTTCGTG -> ACAGTTCGTGA
CACATAATTGA -> ACATAATTGAA
CACATAGTGTA -> ACATAGTGTAT
CACATTTTATG -> ACATTTTATGG
CACCATAGGCT -> ACCATAGGCTT
CACCATGTGAA -> ACCATGTGAAC
CACCGGTCAGT -> ACCGGTCAGTG
CACGAGGGCGA -> ACGAGGGCGAA
CACGCAGCATT -> ACGCAGCATTA
CACGCCCGAGA -> ACGCCCGAGAC
CACGCCTGGGC -> ACGCCTGGGCA
CACGGCCGGAA -> ACGGCCGGAAC
CACGGTACAAG -> ACGGTACAAGC
CACGGTCGTTG -> ACGGTCGTTGC
CACGGTCTTGA -> ACGGTCTTGAG
CACGGTGCCTG -> ACGGTGCCTGC
CACGTAACCAA -> ACGTAACCAAC
CACGTAGGACG -> ACGTAGGACGA
CACGTCCAGAG -> ACGTCCAGAGG
CACGTGCGAGT -> ACGTGCGAGTC
CACGTTCACTC -> ACGTTCACTCA
CACGTTTGGCT -> ACGTTTGGCTC
CACTCACACAC -> ACTCACACACG
CACTCAGCAAT -> ACTCAGCAATG
CACTCTTCTAA -> ACTCTTCTAAA
CACTGGTGTTG -> ACTGGTGTTGT
CACTGTCACAC -> ACTGTCACACG
CACTGTGTCCT -> ACTGTGTCCTG
CACTTAAAGCG -> ACTTAAAGCGG
CACTTGACGTG -> ACTTGACGTGG
CAGAACCGCAT -> AGAACCGCATG
CAGACCAATCG -> AGACCAATCGA
CAGACTCGTGG -> AGACTCGTGGG
CAGACTTAACG -> AGACTTAACGT
CAGACTTATAG -> AGACTTATAGA
CAGAGGGAGGA -> AGAGGGAGGAT
CAGAGTCATCG -> AGAGTCATCGC
CAGAGTGAGAG -> AGAGTGAGAGT
CAGATCGGCTC -> AGATCGGCTCA
CAGATTGAGCG -> AGATTGAGCGG
CAGCAATGTAT -> AGCAATGTATA
CAGCATTAAAG -> AGCATTAAAGA
CAGCCAGGCCT -> AGCCAGGCCTC
CAGCCGCCAGG -> AGCCGCCAGGT
CAGCCTACCCG -> AGCCTACCCGG
CAGCGGTCTCA -> AGCGGTCTCAC
CAGCTTAAATA -> AGCTTAAATAG
CAGCTTTCCAC -> AGCTTTCCACG
CAGGCAGACCA -> AGGCAGACCAA
CAGGCCATATA -> AGGCCATATAT
CAGGCCTCGTA -> AGGCCTCGTAA
CAGGCCTTTCC -> AGGCCTTTCCG
CAGGCTAATTT -> AGGCTAATTTG
CAGGGGATCAC -> AGGGGATCACA
CAGGTCAAGGT -> AGGTCAAGGTA
CAGGTCCAAGT -> AGGTCCAAGTC
CAGGTGGGTGC -> AGGTGGGTGCT
CAGTAAATATC -> AGTAAATATCA
CAGTACAGGCA -> AGTACAGGCAG
CAGTCTCTATA -> AGTCTCTATAC
CAGTCTGGGGA -> AGTCTGGGGAA
CAGTGACCTGA -> AGTGACCTGAG
CAGTTAAGAGC -> AGTTAAGAGCA
CAGTTACAAAA -> AGTTACAAAAT
CAGTTCGTGAC -> AGTTCGTGACG
CAGTTCTTACA -> AGTTCTTACAT
CAGTTGAATTG -> AGTTGAATTGA
CAGTTGACTCG -> AGTTGACTCGA
CAGTTGGTCTG -> AGTTGGTCTGG
CATAAAACAGT -> ATAAAACAGTA
CATAACACAAA -> ATAACACAAAT
CATAAGCTACG -> ATAAGCTACGG
CATAATTGAAT -> ATAATTGAATG
CATAGGCTTTA -> ATAGGCTTTAT
CATAGTGTATC -> ATAGTGTATCG
CATATATTTGT -> ATATATTTGTG
CATCAAAGGAT -> ATCAAAGGATG
CATCAATCTCA -> ATCAATCTCAC
CATCAGAGTGA -> ATCAGAGTGAG
CATCAGTTCTT -> ATCAGTTCTTA
CATCGACTTGC -> ATCGACTTGCT
CATCGCGAACT -> ATCGCGAACTT
CATCTACAAGC -> ATCTACAAGCA
CATCTGACAAG -> ATCTGACAAGA
CATCTGGGGAA -> ATCTGGGGAAC
CATCTTCTTTG -> ATCTTCTTTGA
CATGACGGGGC -> ATGACGGGGCC
CATGATCTATT -> ATGATCTATTA
CATGCCAACCC -> ATGCCAACCCG
CATGCGGCATT -> ATGCGGCATTT
CATGCGGCGCG -> ATGCGGCGCGC
CATGGTAAGGA -> ATGGTAAGGAC
CATGGTCAGAA -> ATGGTCAGAAC
CATGTCCTCCA -> ATGTCCTCCAA
CATGTGAACCT -> ATGTGAACCTT
CATTAAAGAAT -> ATTAAAGAATC
CATTAATGTCC -> ATTAATGTCCT
CATTACCCCGC -> ATTACCCCGCA
CATTCGCAAAG -> ATTCGCAAAGA
CATTCGCAGGC -> ATTCGCAGGCT
CATTGAGCAAT -> ATTGAGCAATC
CATTGGAAGTT -> ATTGGAAGTTA
CATTTAATACT -> ATTTAATACTA
CATTTCGTTGT -> ATTTCGTTGTG
CATTTTATGGG -> ATTTTATGGGA
CCAAATGAGAA -> CAAATGAGAAA
CCAACCCGACT -> CAACCCGACTG
CCAACGATCGG -> CAACGATCGGG
CCAACGGAACA -> CAACGGAACAC
CCAACGTCCTA -> CAACGTCCTAG
CCAACGTCGCT -> CAACGTCGCTG
CCAAGGGAGAG -> CAAGGGAGAGA
CCAAGTCGATA -> CAAGTCGATAG
CCAAGTGCATC -> CAAGTGCATCA
CCAATCGAGGC -> CAATCGAGGCG
CCACACAGCCA -> CACACAGCCAG
CCACCATGTGA -> CACCATGTGAA
CCACGTTCACT -> CACGTTCACTC
CCACTGTGTCC -> CACTGTGTCCT
CCAGAGGGAGG -> CAGAGGGAGGA
CCAGAGTCATC -> CAGAGTCATCG
CCAGCTTAAAT -> CAGCTTAAATA
CCAGGCCTCGT -> CAGGCCTCGTA
CCAGGTCAAGG -> CAGGTCAAGGT
CCAGTACAGGC -> CAGTACAGGCA
CCAGTCTGGGG -> CAGTCTGGGGA
CCAGTTGACTC -> CAGTTGACTCG
CCAGTTGGTCT -> CAGTTGGTCTG
CCATAACACAA -> CATAACACAAA
CCATAGGCTTT -> CATAGGCTTTA
CCATATATTTG -> CATATATTTGT
CCATCAATCTC -> CATCAATCTCA
CCATGACGGGG -> CATGACGGGGC
CCATGCGGCGC -> CATGCGGCGCG
CCATGTCCTCC -> CATGTCCTCCA
CCATGTGAACC -> CATGTGAACCT
CCATTGGAAGT -> CATTGGAAGTT
CCATTTAATAC -> CATTTAATACT
CCCAAGGGAGA -> CCAAGGGAGAG
CCCAGAGTCAT -> CCAGAGTCATC
CCCAGTTGGTC -> CCAGTTGGTCT
CCCATAACACA -> CCATAACACAA
CCCATGTCCTC -> CCATGTCCTCC
CCCATTTAATA -> CCATTTAATAC
CCCCAAGGGAG -> CCCAAGGGAGA
CCCCATGTCCT -> CCCATGTCCTC
CCCCGCAGTTG -> CCCGCAGTTGA
CCCCGGCTACC -> CCCGGCTACCT
CCCCGTTGCAT -> CCCGTTGCATA
CCCGACGGAGT -> CCGACGGAGTA
CCCGACTGAGC -> CCGACTGAGCC
CCCGAGACGAC -> CCGAGACGACC
CCCGCAGTTGA -> CCGCAGTTGAA
CCCGGAGTCGT -> CCGGAGTCGTC
CCCGGATTGTA -> CCGGATTGTAC
CCCGGCTACCT -> CCGGCTACCTA
CCCGGTTCCAA -> CCGGTTCCAAG
CCCGTGGCGTA -> CCGTGGCGTAC
CCCGTTAGCCT -> CCGTTAGCCTC
CCCGTTGCATA -> CCGTTGCATAA
CCCTCTCATTA -> CCTCTCATTAA
CCCTTCACAGT -> CCTTCACAGTC
CCGAAGGTCAC -> CGAAGGTCACG
CCGAATCCCTT -> CGAATCCCTTC
CCGACGGAGTA -> CGACGGAGTAA
CCGACTGAGCC -> CGACTGAGCCA
CCGAGACGACC -> CGAGACGACCT
CCGCAATGATA -> CGCAATGATAT
CCGCACATAGT -> CGCACATAGTG
CCGCAGTTGAA -> CGCAGTTGAAT
CCGCATGCGGC -> CGCATGCGGCA
CCGCCAGGTCA -> CGCCAGGTCAA
CCGGAACCTGG -> CGGAACCTGGT
CCGGAGTCGTC -> CGGAGTCGTCG
CCGGATTGTAC -> CGGATTGTACG
CCGGCACACTC -> CGGCACACTCT
CCGGCTACCTA -> CGGCTACCTAC
CCGGCTCGTGG -> CGGCTCGTGGC
CCGGCTCTATA -> CGGCTCTATAC
CCGGGACAATA -> CGGGACAATAC
CCGGTCAGTGA -> CGGTCAGTGAC
CCGGTTCCAAG -> CGGTTCCAAGT
CCGTACGGAGA -> CGTACGGAGAT
CCGTCGTCTCT -> CGTCGTCTCTT
CCGTGGCGTAC -> CGTGGCGTACC
CCGTGTCAACC -> CGTGTCAACCT
CCGTTAGCCTC -> CGTTAGCCTCT
CCGTTGCATAA -> CGTTGCATAAG
CCTAATCAGAC -> CTAATCAGACT
CCTACCCGGTT -> CTACCCGGTTC
CCTACGCCCCA -> CTACGCCCCAT
CCTAGACTTGT -> CTAGACTTGTG
CCTAGTCCGAA -> CTAGTCCGAAT
CCTATAACTCA -> CTATAACTCAC
CCTCACACCAT -> CTCACACCATA
CCTCACTTAAA -> CTCACTTAAAG
CCTCATCAGTT -> CTCATCAGTTC
CCTCATGGTCA -> CTCATGGTCAG
CCTCCAACGGA -> CTCCAACGGAA
CCTCGTAACCC -> CTCGTAACCCG
CCTCTCATTAA -> CTCTCATTAAT
CCTCTGCGGGG -> CTCTGCGGGGC
CCTCTTATCAA -> CTCTTATCAAC
CCTGACCCATT -> CTGACCCATTT
CCTGAGAGCGA -> CTGAGAGCGAA
CCTGAGCTGCT -> CTGAGCTGCTA
CCTGAGTCAAG -> CTGAGTCAAGG
CCTGAGTCATT -> CTGAGTCATTG
CCTGAGTTGGG -> CTGAGTTGGGC
CCTGCCATTGG -> CTGCCATTGGA
CCTGGGCATCT -> CTGGGCATCTG
CCTGGTCAGGT -> CTGGTCAGGTC
CCTGTCTATCT -> CTGTCTATCTC
CCTTAACCAGT -> CTTAACCAGTC
CCTTAGCCTCA -> CTTAGCCTCAT
CCTTCACAGTC -> CTTCACAGTCT
CCTTGACAGAC -> CTTGACAGACT
CCTTGACCAGT -> CTTGACCAGTA
CCTTGGAGAAG -> CTTGGAGAAGG
CCTTTCAGCGG -> CTTTCAGCGGT
CCTTTCCGGCT -> CTTTCCGGCTC
CGAACTTTGGT -> GAACTTTGGTG
CGAAGCGTAGA -> GAAGCGTAGAC
CGAAGGTCACG -> GAAGGTCACGG
CGAATCAAAAA -> GAATCAAAAAT
CGAATCCCTTC -> GAATCCCTTCA
CGAATGATTCG -> GAATGATTCGA
CGAATTCACTT -> GAATTCACTTG
CGACACACGCA -> GACACACGCAG
CGACCTAGTCC -> GACCTAGTCCG
CGACGGAGTAA -> GACGGAGTAAC
CGACGGTTCAC -> GACGGTTCACG
CGACGTCCTAT -> GACGTCCTATA
CGACTGAGCCA -> GACTGAGCCAT
CGACTTGCTAA -> GACTTGCTAAT
CGAGAATCGCG -> GAGAATCGCGC
CGAGACACAGT -> GAGACACAGTT
CGAGACGACCT -> GAGACGACCTA
CGAGGCGCAAC -> GAGGCGCAACG
CGAGGGCGAAT -> GAGGGCGAATG
CGAGGGGCAGT -> GAGGGGCAGTT
CGAGGTGGTGA -> GAGGTGGTGAG
CGAGTCACTGG -> GAGTCACTGGT
CGAGTCGAATC -> GAGTCGAATCA
CGATAGTACAC -> GATAGTACACG
CGATCGGGCAT -> GATCGGGCATA
CGATGATCATG -> GATGATCATGA
CGATTCAAACT -> GATTCAAACTC
CGCAAACCTCA -> GCAAACCTCAC
CGCAAAGAGGT -> GCAAAGAGGTA
CGCAACGATGA -> GCAACGATGAT
CGCAATGATAT -> GCAATGATATG
CGCACATAGTG -> GCACATAGTGT
CGCACGTAACC -> GCACGTAACCA
CGCAGCATTAA -> GCAGCATTAAA
CGCAGCCTACC -> GCAGCCTACCC
CGCAGGCTAAT -> GCAGGCTAATT
CGCAGTTGAAT -> GCAGTTGAATT
CGCATGCGGCA -> GCATGCGGCAT
CGCATTACCCC -> GCATTACCCCG
CGCCAACGTCC -> GCCAACGTCCT
CGCCAGCTTAA -> GCCAGCTTAAA
CGCCAGGTCAA -> GCCAGGTCAAG
CGCCCCATGTC -> GCCCCATGTCC
CGCCCGAGACG -> GCCCGAGACGA
CGCCTGAGTTG -> GCCTGAGTTGG
CGCCTGGGCAT -> GCCTGGGCATC
CGCCTTAACCA -> GCCTTAACCAG
CGCGAACTTTG -> GCGAACTTTGG
CGCGAAGCGTA -> GCGAAGCGTAG
CGCGCAAACCT -> GCGCAAACCTC
CGCGCAGCCTA -> GCGCAGCCTAC
CGCGCGTACCC -> GCGCGTACCCC
CGCGTACCCCA -> GCGTACCCCAA
CGCTGTGTTAG -> GCTGTGTTAGG
CGGAAAACTGT -> GGAAAACTGTC
CGGAACACGGT -> GGAACACGGTA
CGGAACCTGGT -> GGAACCTGGTC
CGGAGATATCC -> GGAGATATCCT
CGGAGTAACAC -> GGAGTAACACG
CGGAGTCGTCG -> GGAGTCGTCGG
CGGATTGTACG -> GGATTGTACGC
CGGCACACTCT -> GGCACACTCTT
CGGCATTTCGT -> GGCATTTCGTT
CGGCCACCATG -> GGCCACCATGT
CGGCCGAAGGT -> GGCCGAAGGTC
CGGCCGGAACC -> GGCCGGAACCT
CGGCGAGTCAC -> GGCGAGTCACT
CGGCGCGCAAA -> GGCGCGCAAAC
CGGCTAAGAGT -> GGCTAAGAGTT
CGGCTACCTAC -> GGCTACCTACG
CGGCTCACAGG -> GGCTCACAGGC
CGGCTCGTGGC -> GGCTCGTGGCC
CGGCTCTATAC -> GGCTCTATACG
CGGGACAATAC -> GGGACAATACT
CGGGCATAAAA -> GGGCATAAAAC
CGGGGAGGCAA -> GGGGAGGCAAA
CGGGGCAAAAG -> GGGGCAAAAGA
CGGGGCCTCAT -> GGGGCCTCATG
CGGGGTCCACA -> GGGGTCCACAC
CGGGTTGTTAT -> GGGTTGTTATT
CGGTACAAGCA -> GGTACAAGCAT
CGGTCAGTGAC -> GGTCAGTGACC
CGGTCGTTGCC -> GGTCGTTGCCG
CGGTCTCACGT -> GGTCTCACGTC
CGGTCTTGAGA -> GGTCTTGAGAC
CGGTGCCTGCC -> GGTGCCTGCCA
CGGTTAAGATC -> GGTTAAGATCC
CGGTTCACGTA -> GGTTCACGTAG
CGGTTCCAAGT -> GGTTCCAAGTG
CGTAACCAACG -> GTAACCAACGT
CGTAACCCGGA -> GTAACCCGGAT
CGTACCCCAAG -> GTACCCCAAGG
CGTACCCTCTC -> GTACCCTCTCA
CGTACGGAGAT -> GTACGGAGATA
CGTAGACGCCT -> GTAGACGCCTT
CGTAGGACGAC -> GTAGGACGACA
CGTATTTCCGC -> GTATTTCCGCA
CGTCACCGGTC -> GTCACCGGTCA
CGTCCAGAGGG -> GTCCAGAGGGA
CGTCCTAGACT -> GTCCTAGACTT
CGTCCTATAAC -> GTCCTATAACT
CGTCGCTGTGT -> GTCGCTGTGTT
CGTCGGAAAAC -> GTCGGAAAACT
CGTCGTCTCTT -> GTCGTCTCTTC
CGTCTCTTCAG -> GTCTCTTCAGG
CGTCTGTGTGT -> GTCTGTGTGTA
CGTGACGGGGT -> GTGACGGGGTC
CGTGCGAGTCG -> GTGCGAGTCGA
CGTGGCCATGC -> GTGGCCATGCG
CGTGGCGTACC -> GTGGCGTACCC
CGTGGGTCATT -> GTGGGTCATTC
CGTGGTGCCTG -> GTGGTGCCTGT
CGTGTCAACCT -> GTGTCAACCTA
CGTGTCCGGCT -> GTGTCCGGCTC
CGTGTGCCTCA -> GTGTGCCTCAC
CGTTACCCGTG -> GTTACCCGTGG
CGTTAGCCTCT -> GTTAGCCTCTT
CGTTCACTCAC -> GTTCACTCACA
CGTTGCATAAG -> GTTGCATAAGC
CGTTGCCGGGA -> GTTGCCGGGAC
CGTTGTGAATA -> GTTGTGAATAT
CGTTTGGCTCC -> GTTTGGCTCCT
CTAAATATTGA -> TAAATATTGAG
CTAAGAGTTCT -> TAAGAGTTCTG
CTAATAGACCC -> TAATAGACCCC
CTAATCAGACT -> TAATCAGACTT
CTAATCTATTC -> TAATCTATTCA
CTAATTTGTGA -> TAATTTGTGAG
CTACAAGCACG -> TACAAGCACGT
CTACCCCGGCT -> TACCCCGGCTA
CTACCCGGTTC -> TACCCGGTTCC
CTACCTACGCC -> TACCTACGCCC
CTACGCCCCAT -> TACGCCCCATG
CTACGGCTAAG -> TACGGCTAAGA
CTACTGGATCA -> TACTGGATCAT
CTAGAATCCCG -> TAGAATCCCGG
CTAGACTTGTG -> TAGACTTGTGT
CTAGCACGCCC -> TAGCACGCCCG
CTAGTCCGAAT -> TAGTCCGAATC
CTATAACTCAC -> TATAACTCACA
CTATACCGTGT -> TATACCGTGTC
CTATACGTATT -> TATACGTATTT
CTATATGCCTG -> TATATGCCTGA
CTATCTCCAGT -> TATCTCCAGTT
CTATGAACAGG -> TATGAACAGGT
CTATTAACTAG -> TATTAACTAGA
CTATTCAGCTT -> TATTCAGCTTT
CTCAACATCGA -> TCAACATCGAC
CTCACACACGC -> TCACACACGCC
CTCACACCATA -> TCACACCATAG
CTCACACTCAG -> TCACACTCAGC
CTCACAGGCCT -> TCACAGGCCTT
CTCACATAATT -> TCACATAATTG
CTCACGTCCAG -> TCACGTCCAGA
CTCACTTAAAG -> TCACTTAAAGC
CTCAGATCGGC -> TCAGATCGGCT
CTCAGCAATGT -> TCAGCAATGTA
CTCATCAGTTC -> TCATCAGTTCT
CTCATGGTCAG -> TCATGGTCAGA
CTCATTAATGT -> TCATTAATGTC
CTCCAACGGAA -> TCCAACGGAAC
CTCCAGTTGAC -> TCCAGTTGACT
CTCCCAGTTGG -> TCCCAGTTGGT
CTCCGCAATGA -> TCCGCAATGAT
CTCCTCTGCGG -> TCCTCTGCGGG
CTCGATTCAAA -> TCGATTCAAAC
CTCGCCAGCTT -> TCGCCAGCTTA
CTCGTAACCCG -> TCGTAACCCGG
CTCGTCACCGG -> TCGTCACCGGT
CTCGTGGCCAT -> TCGTGGCCATG
CTCGTGGGTCA -> TCGTGGGTCAT
CTCTATACCGT -> TCTATACCGTG
CTCTATACGTA -> TCTATACGTAT
CTCTCATTAAT -> TCTCATTAATG
CTCTGCGGGGC -> TCTGCGGGGCA
CTCTTATCAAC -> TCTTATCAACT
CTCTTCAGGGG -> TCTTCAGGGGA
CTCTTCATCTG -> TCTTCATCTGA
CTCTTCTAAAT -> TCTTCTAAATA
CTGAACACGGC -> TGAACACGGCC
CTGACAAGATC -> TGACAAGATCT
CTGACCCATTT -> TGACCCATTTA
CTGAGAGCGAA -> TGAGAGCGAAT
CTGAGCCATCA -> TGAGCCATCAA
CTGAGCTGCTA -> TGAGCTGCTAA
CTGAGTCAAGG -> TGAGTCAAGGC
CTGAGTCATTG -> TGAGTCATTGA
CTGAGTTGGGC -> TGAGTTGGGCC
CTGCAACGACG -> TGCAACGACGG
CTGCCATTGGA -> TGCCATTGGAA
CTGCGGGGCAA -> TGCGGGGCAAA
CTGCTAATAGA -> TGCTAATAGAC
CTGCTCCCAGT -> TGCTCCCAGTT
CTGGATCATGG -> TGGATCATGGT
CTGGGCATCTG -> TGGGCATCTGG
CTGGGCCTTTC -> TGGGCCTTTCA
CTGGGGAACTG -> TGGGGAACTGC
CTGGGGAATCC -> TGGGGAATCCC
CTGGTCAGGTC -> TGGTCAGGTCC
CTGGTGGGTCG -> TGGTGGGTCGC
CTGGTGTTGTC -> TGGTGTTGTCG
CTGTCACACGG -> TGTCACACGGT
CTGTCCTGACC -> TGTCCTGACCC
CTGTCTATCTC -> TGTCTATCTCC
CTGTGGAGCAT -> TGTGGAGCATT
CTGTGTCCTGA -> TGTGTCCTGAG
CTGTGTGTATT -> TGTGTGTATTT
CTGTGTTAGGA -> TGTGTTAGGAT
CTTAAAGCGGC -> TTAAAGCGGCG
CTTAAATAGGG -> TTAAATAGGGG
CTTAACCAGTC -> TTAACCAGTCT
CTTAACGTCTG -> TTAACGTCTGT
CTTACATCAAA -> TTACATCAAAG
CTTAGCCTCAT -> TTAGCCTCATC
CTTATAGACCA -> TTATAGACCAC
CTTATCAACTC -> TTATCAACTCG
CTTCACAGTCT -> TTCACAGTCTC
CTTCAGGGGAT -> TTCAGGGGATC
CTTCATCTGAC -> TTCATCTGACA
CTTCTAAATAT -> TTCTAAATATT
CTTCTTTGAGA -> TTCTTTGAGAG
CTTGACAGACT -> TTGACAGACTT
CTTGACCAGTA -> TTGACCAGTAC
CTTGACGTGGT -> TTGACGTGGTG
CTTGAGACTCA -> TTGAGACTCAA
CTTGCTAATCT -> TTGCTAATCTA
CTTGGAGAAGG -> TTGGAGAAGGA
CTTGTGTTGGG -> TTGTGTTGGGG
CTTTATACCGG -> TTTATACCGGC
CTTTCAGCGGT -> TTTCAGCGGTC
CTTTCCACGTT -> TTTCCACGTTC
CTTTCCGGCTC -> TTTCCGGCTCG
CTTTGAGAGTA -> TTTGAGAGTAC
CTTTGGTGCGA -> TTTGGTGCGAG
GAAAAAAAACA -> AAAAAAAACAT
GAAAACTGTCC -> AAAACTGTCCT
GAACACGGCCG -> AACACGGCCGG
GAACACGGTAC -> AACACGGTACA
GAACAGGCCAT -> AACAGGCCATA
GAACAGGTGGG -> AACAGGTGGGT
GAACCCGTTAG -> AACCCGTTAGC
GAACCGCATGC -> AACCGCATGCG
GAACCTGGTCA -> AACCTGGTCAG
GAACCTTGACA -> AACCTTGACAG
GAACCTTGGAG -> AACCTTGGAGA
GAACTGCTCCC -> AACTGCTCCCA
GAACTTTGGTG -> AACTTTGGTGC
GAAGCGTAGAC -> AAGCGTAGACG
GAAGGACAGAC -> AAGGACAGACT
GAAGGTCACGG -> AAGGTCACGGT
GAAGTTAATCA -> AAGTTAATCAA
GAATATCGCGA -> AATATCGCGAA
GAATCAAAAAT -> AATCAAAAATG
GAATCCCATAA -> AATCCCATAAC
GAATCCCGGAG -> AATCCCGGAGT
GAATCCCTTCA -> AATCCCTTCAC
GAATCGCGCAG -> AATCGCGCAGC
GAATCTACTGG -> AATCTACTGGA
GAATGATGATG -> AATGATGATGT
GAATGATTCGA -> AATGATTCGAG
GAATTCACTTG -> AATTCACTTGA
GAATTGAGTCG -> AATTGAGTCGT
GACAAGATCTA -> ACAAGATCTAT
GACAATACTGT -> ACAATACTGTG
GACAATTTCTC -> ACAATTTCTCT
GACACACGCAG -> ACACACGCAGC
GACACAGTTCG -> ACACAGTTCGT
GACAGACTCGT -> ACAGACTCGTG
GACAGACTTAA -> ACAGACTTAAC
GACCAATCGAG -> ACCAATCGAGG
GACCACTGTGT -> ACCACTGTGTC
GACCAGTACAG -> ACCAGTACAGG
GACCCAGAGTC -> ACCCAGAGTCA
GACCCATTTAA -> ACCCATTTAAT
GACCCCGTTGC -> ACCCCGTTGCA
GACCTAGTCCG -> ACCTAGTCCGA
GACCTGAGCTG -> ACCTGAGCTGC
GACGACACACG -> ACGACACACGC
GACGACCTAGT -> ACGACCTAGTC
GACGACGTCCT -> ACGACGTCCTA
GACGCCTTAAC -> ACGCCTTAACC
GACGGAGTAAC -> ACGGAGTAACA
GACGGCCGAAG -> ACGGCCGAAGG
GACGGGGCCTC -> ACGGGGCCTCA
GACGGGGTCCA -> ACGGGGTCCAC
GACGGTTCACG -> ACGGTTCACGT
GACGTCCTATA -> ACGTCCTATAA
GACGTGGTGCC -> ACGTGGTGCCT
GACTCAACATC -> ACTCAACATCG
GACTCGATTCA -> ACTCGATTCAA
GACTCGTGGGT -> ACTCGTGGGTC
GACTGAGCCAT -> ACTGAGCCATC
GACTTAACGTC -> ACTTAACGTCT
GACTTATAGAC -> ACTTATAGACC
GACTTGCTAAT -> ACTTGCTAATC
GACTTGTGTTG -> ACTTGTGTTGG
GAGAAAAAAAA -> AGAAAAAAAAC
GAGAACAGGCC -> AGAACAGGCCA
GAGAAGGACAG -> AGAAGGACAGA
GAGAATCGCGC -> AGAATCGCGCA
GAGACACAGTT -> AGACACAGTTC
GAGACGACCTA -> AGACGACCTAG
GAGACGACGTC -> AGACGACGTCC
GAGACGGCCGA -> AGACGGCCGAA
GAGACTCAACA -> AGACTCAACAT
GAGAGAACAGG -> AGAGAACAGGC
GAGAGCGAATT -> AGAGCGAATTC
GAGAGTACGTG -> AGAGTACGTGT
GAGAGTTTCAA -> AGAGTTTCAAA
GAGATATCCTT -> AGATATCCTTG
GAGATTGGTCT -> AGATTGGTCTC
GAGCAATCAGC -> AGCAATCAGCC
GAGCAGATTGA -> AGCAGATTGAG
GAGCATTCGCA -> AGCATTCGCAG
GAGCCATCAAT -> AGCCATCAATC
GAGCCGTCGTC -> AGCCGTCGTCT
GAGCGAATTCA -> AGCGAATTCAC
GAGCGGCCACC -> AGCGGCCACCA
GAGCGGTTAAG -> AGCGGTTAAGA
GAGCTGCTAAT -> AGCTGCTAATA
GAGGAACCCGT -> AGGAACCCGTT
GAGGATGGCTC -> AGGATGGCTCG
GAGGCAAAGTC -> AGGCAAAGTCT
GAGGCGCAACG -> AGGCGCAACGA
GAGGGAGGATG -> AGGGAGGATGG
GAGGGCGAATG -> AGGGCGAATGA
GAGGGGCAGTT -> AGGGGCAGTTA
GAGGTAAATGT -> AGGTAAATGTA
GAGGTGGTGAG -> AGGTGGTGAGC
GAGTAACACGA -> AGTAACACGAG
GAGTACGTGTG -> AGTACGTGTGC
GAGTCAAGGCA -> AGTCAAGGCAC
GAGTCACTGGT -> AGTCACTGGTG
GAGTCATCGCG -> AGTCATCGCGA
GAGTCATTGAG -> AGTCATTGAGC
GAGTCGAATCA -> AGTCGAATCAA
GAGTCGTCGGA -> AGTCGTCGGAA
GAGTCGTGTCC -> AGTCGTGTCCG
GAGTGAGAGTT -> AGTGAGAGTTT
GAGTTCTGCAA -> AGTTCTGCAAC
GAGTTGGGCCT -> AGTTGGGCCTT
GAGTTTCAAAT -> AGTTTCAAATT
GATAGTACACG -> ATAGTACACGT
GATATCCTTGA -> ATATCCTTGAC
GATATCGCACG -> ATATCGCACGT
GATATGTTAAG -> ATATGTTAAGA
GATCACATTTT -> ATCACATTTTA
GATCATGATCT -> ATCATGATCTA
GATCATGGTAA -> ATCATGGTAAG
GATCCAAATGA -> ATCCAAATGAG
GATCGAGAATC -> ATCGAGAATCG
GATCGGCTCAC -> ATCGGCTCACA
GATCGGGCATA -> ATCGGGCATAA
GATCTATGAAC -> ATCTATGAACA
GATCTATTAAC -> ATCTATTAACT
GATGATCATGA -> ATGATCATGAT
GATGATGTTGT -> ATGATGTTGTG
GATGGACAATT -> ATGGACAATTT
GATGGCTCGCC -> ATGGCTCGCCA
GATGTACATGC -> ATGTACATGCC
GATGTCAATGC -> ATGTCAATGCG
GATGTTGTGGT -> ATGTTGTGGTA
GATTCAAACTC -> ATTCAAACTCA
GATTCGAGACA -> ATTCGAGACAC
GATTGAGCGGC -> ATTGAGCGGCC
GATTGGTCTCA -> ATTGGTCTCAC
GATTGTACGCG -> ATTGTACGCGC
GCAAAAGAGGA -> CAAAAGAGGAA
GCAAACCTCAC -> CAAACCTCACT
GCAAAGAGGTA -> CAAAGAGGTAA
GCAAAGTCTAC -> CAAAGTCTACC
GCAACGACGGT -> CAACGACGGTT
GCAACGATGAT -> CAACGATGATC
GCAATCAGCCG -> CAATCAGCCGC
GCAATGATATG -> CAATGATATGT
GCAATGTATAA -> CAATGTATAAC
GCACACTCTTC -> CACACTCTTCT
GCACATAGTGT -> CACATAGTGTA
GCACGCCCGAG -> CACGCCCGAGA
GCACGGTCGTT -> CACGGTCGTTG
GCACGTAACCA -> CACGTAACCAA
GCACGTTTGGC -> CACGTTTGGCT
GCAGACCAATC -> CAGACCAATCG
GCAGATTGAGC -> CAGATTGAGCG
GCAGCATTAAA -> CAGCATTAAAG
GCAGCCTACCC -> CAGCCTACCCG
GCAGGCTAATT -> CAGGCTAATTT
GCAGTTACAAA -> CAGTTACAAAA
GCAGTTGAATT -> CAGTTGAATTG
GCATAAAACAG -> CATAAAACAGT
GCATAAGCTAC -> CATAAGCTACG
GCATCAGAGTG -> CATCAGAGTGA
GCATCTGGGGA -> CATCTGGGGAA
GCATCTTCTTT -> CATCTTCTTTG
GCATGCGGCAT -> CATGCGGCATT
GCATTAAAGAA -> CATTAAAGAAT
GCATTACCCCG -> CATTACCCCGC
GCATTCGCAGG -> CATTCGCAGGC
GCATTTCGTTG -> CATTTCGTTGT
GCCAACCCGAC -> CCAACCCGACT
GCCAACGTCCT -> CCAACGTCCTA
GCCACCATGTG -> CCACCATGTGA
GCCAGCTTAAA -> CCAGCTTAAAT
GCCAGGCCTCG -> CCAGGCCTCGT
GCCAGGTCAAG -> CCAGGTCAAGG
GCCATATATTT -> CCATATATTTG
GCCATCAATCT -> CCATCAATCTC
GCCATGACGGG -> CCATGACGGGG
GCCATGCGGCG -> CCATGCGGCGC
GCCATTGGAAG -> CCATTGGAAGT
GCCCCATGTCC -> CCCCATGTCCT
GCCCGACGGAG -> CCCGACGGAGT
GCCCGAGACGA -> CCCGAGACGAC
GCCGAAGGTCA -> CCGAAGGTCAC
GCCGCCAGGTC -> CCGCCAGGTCA
GCCGGAACCTG -> CCGGAACCTGG
GCCGGGACAAT -> CCGGGACAATA
GCCGTACGGAG -> CCGTACGGAGA
GCCGTCGTCTC -> CCGTCGTCTCT
GCCTACCCGGT -> CCTACCCGGTT
GCCTCACACCA -> CCTCACACCAT
GCCTCATCAGT -> CCTCATCAGTT
GCCTCATGGTC -> CCTCATGGTCA
GCCTCGTAACC -> CCTCGTAACCC
GCCTCTTATCA -> CCTCTTATCAA
GCCTGAGAGCG -> CCTGAGAGCGA
GCCTGAGTTGG -> CCTGAGTTGGG
GCCTGCCATTG -> CCTGCCATTGG
GCCTGGGCATC -> CCTGGGCATCT
GCCTGTCTATC -> CCTGTCTATCT
GCCTTAACCAG -> CCTTAACCAGT
GCCTTAGCCTC -> CCTTAGCCTCA
GCCTTTCAGCG -> CCTTTCAGCGG
GCCTTTCCGGC -> CCTTTCCGGCT
GCGAACTTTGG -> CGAACTTTGGT
GCGAAGCGTAG -> CGAAGCGTAGA
GCGAATGATTC -> CGAATGATTCG
GCGAATTCACT -> CGAATTCACTT
GCGAGGGGCAG -> CGAGGGGCAGT
GCGAGTCACTG -> CGAGTCACTGG
GCGAGTCGAAT -> CGAGTCGAATC
GCGCAAACCTC -> CGCAAACCTCA
GCGCAACGATG -> CGCAACGATGA
GCGCAGCCTAC -> CGCAGCCTACC
GCGCGCAAACC -> CGCGCAAACCT
GCGCGTACCCC -> CGCGTACCCCA
GCGGCATTTCG -> CGGCATTTCGT
GCGGCCACCAT -> CGGCCACCATG
GCGGCGAGTCA -> CGGCGAGTCAC
GCGGCGCGCAA -> CGGCGCGCAAA
GCGGGGAGGCA -> CGGGGAGGCAA
GCGGGGCAAAA -> CGGGGCAAAAG
GCGGTCTCACG -> CGGTCTCACGT
GCGGTTAAGAT -> CGGTTAAGATC
GCGTACCCCAA -> CGTACCCCAAG
GCGTACCCTCT -> CGTACCCTCTC
GCGTAGACGCC -> CGTAGACGCCT
GCTAAGAGTTC -> CTAAGAGTTCT
GCTAATAGACC -> CTAATAGACCC
GCTAATCTATT -> CTAATCTATTC
GCTAATTTGTG -> CTAATTTGTGA
GCTACCTACGC -> CTACCTACGCC
GCTACGGCTAA -> CTACGGCTAAG
GCTCACAGGCC -> CTCACAGGCCT
GCTCCCAGTTG -> CTCCCAGTTGG
GCTCCTCTGCG -> CTCCTCTGCGG
GCTCGCCAGCT -> CTCGCCAGCTT
GCTCGTGGCCA -> CTCGTGGCCAT
GCTCTATACGT -> CTCTATACGTA
GCTGCTAATAG -> CTGCTAATAGA
GCTGGGCCTTT -> CTGGGCCTTTC
GCTGTGTTAGG -> CTGTGTTAGGA
GCTTAAATAGG -> CTTAAATAGGG
GCTTTATACCG -> CTTTATACCGG
GCTTTCCACGT -> CTTTCCACGTT
GGAAAACTGTC -> GAAAACTGTCC
GGAACACGGTA -> GAACACGGTAC
GGAACCCGTTA -> GAACCCGTTAG
GGAACCTGGTC -> GAACCTGGTCA
GGAACTGCTCC -> GAACTGCTCCC
GGAAGTTAATC -> GAAGTTAATCA
GGAATCCCATA -> GAATCCCATAA
GGACAATACTG -> GACAATACTGT
GGACAATTTCT -> GACAATTTCTC
GGACAGACTCG -> GACAGACTCGT
GGACCCAGAGT -> GACCCAGAGTC
GGACGACACAC -> GACGACACACG
GGAGAAGGACA -> GAGAAGGACAG
GGAGACGGCCG -> GAGACGGCCGA
GGAGAGAACAG -> GAGAGAACAGG
GGAGATATCCT -> GAGATATCCTT
GGAGCATTCGC -> GAGCATTCGCA
GGAGGATGGCT -> GAGGATGGCTC
GGAGGCAAAGT -> GAGGCAAAGTC
GGAGTAACACG -> GAGTAACACGA
GGAGTCGTCGG -> GAGTCGTCGGA
GGATATCGCAC -> GATATCGCACG
GGATCACATTT -> GATCACATTTT
GGATCATGGTA -> GATCATGGTAA
GGATCGAGAAT -> GATCGAGAATC
GGATGGCTCGC -> GATGGCTCGCC
GGATGTCAATG -> GATGTCAATGC
GGATTGTACGC -> GATTGTACGCG
GGCAAAAGAGG -> GCAAAAGAGGA
GGCAAAGTCTA -> GCAAAGTCTAC
GGCACACTCTT -> GCACACTCTTC
GGCACGGTCGT -> GCACGGTCGTT
GGCAGACCAAT -> GCAGACCAATC
GGCAGTTACAA -> GCAGTTACAAA
GGCATAAAACA -> GCATAAAACAG
GGCATCTGGGG -> GCATCTGGGGA
GGCATTTCGTT -> GCATTTCGTTG
GGCCACCATGT -> GCCACCATGTG
GGCCATATATT -> GCCATATATTT
GGCCATGCGGC -> GCCATGCGGCG
GGCCCGACGGA -> GCCCGACGGAG
GGCCGAAGGTC -> GCCGAAGGTCA
GGCCGGAACCT -> GCCGGAACCTG
GGCCGTACGGA -> GCCGTACGGAG
GGCCTCATGGT -> GCCTCATGGTC
GGCCTCGTAAC -> GCCTCGTAACC
GGCCTTAGCCT -> GCCTTAGCCTC
GGCCTTTCAGC -> GCCTTTCAGCG
GGCCTTTCCGG -> GCCTTTCCGGC
GGCGAATGATT -> GCGAATGATTC
GGCGAGTCACT -> GCGAGTCACTG
GGCGCAACGAT -> GCGCAACGATG
GGCGCGCAAAC -> GCGCGCAAACC
GGCGTACCCTC -> GCGTACCCTCT
GGCTAAGAGTT -> GCTAAGAGTTC
GGCTAATTTGT -> GCTAATTTGTG
GGCTACCTACG -> GCTACCTACGC
GGCTCACAGGC -> GCTCACAGGCC
GGCTCCTCTGC -> GCTCCTCTGCG
GGCTCGCCAGC -> GCTCGCCAGCT
GGCTCGTGGCC -> GCTCGTGGCCA
GGCTCTATACG -> GCTCTATACGT
GGCTTTATACC -> GCTTTATACCG
GGGAACTGCTC -> GGAACTGCTCC
GGGAATCCCAT -> GGAATCCCATA
GGGACAATACT -> GGACAATACTG
GGGAGACGGCC -> GGAGACGGCCG
GGGAGAGAACA -> GGAGAGAACAG
GGGAGGATGGC -> GGAGGATGGCT
GGGAGGCAAAG -> GGAGGCAAAGT
GGGATCACATT -> GGATCACATTT
GGGCAAAAGAG -> GGCAAAAGAGG
GGGCAGTTACA -> GGCAGTTACAA
GGGCATAAAAC -> GGCATAAAACA
GGGCATCTGGG -> GGCATCTGGGG
GGGCCCGACGG -> GGCCCGACGGA
GGGCCGTACGG -> GGCCGTACGGA
GGGCCTCATGG -> GGCCTCATGGT
GGGCCTTAGCC -> GGCCTTAGCCT
GGGCCTTTCAG -> GGCCTTTCAGC
GGGCGAATGAT -> GGCGAATGATT
GGGGAACTGCT -> GGGAACTGCTC
GGGGAATCCCA -> GGGAATCCCAT
GGGGAGGCAAA -> GGGAGGCAAAG
GGGGATCACAT -> GGGATCACATT
GGGGCAAAAGA -> GGGCAAAAGAG
GGGGCAGTTAC -> GGGCAGTTACA
GGGGCCCGACG -> GGGCCCGACGG
GGGGCCTCATG -> GGGCCTCATGG
GGGGTCCACAC -> GGGTCCACACA
GGGGTCGTTAC -> GGGTCGTTACC
GGGTCATTCGC -> GGTCATTCGCA
GGGTCCACACA -> GGTCCACACAG
GGGTCGCATTA -> GGTCGCATTAC
GGGTCGTTACC -> GGTCGTTACCC
GGGTGCTGGGC -> GGTGCTGGGCC
GGGTTGTTATT -> GGTTGTTATTC
GGTAAATGTAC -> GTAAATGTACG
GGTAACTGAAC -> GTAACTGAACA
GGTAAGGACCC -> GTAAGGACCCA
GGTAAGGGCCG -> GTAAGGGCCGT
GGTACAAGCAT -> GTACAAGCATC
GGTCAAGGTAA -> GTCAAGGTAAG
GGTCACGGTCT -> GTCACGGTCTT
GGTCAGAACCG -> GTCAGAACCGC
GGTCAGGTCCA -> GTCAGGTCCAA
GGTCAGTGACC -> GTCAGTGACCT
GGTCATTCGCA -> GTCATTCGCAA
GGTCCAAGTCG -> GTCCAAGTCGA
GGTCCACACAG -> GTCCACACAGC
GGTCGCATTAC -> GTCGCATTACC
GGTCGTTACCC -> GTCGTTACCCG
GGTCGTTGCCG -> GTCGTTGCCGG
GGTCTCACATA -> GTCTCACATAA
GGTCTCACGTC -> GTCTCACGTCC
GGTCTGGTGGG -> GTCTGGTGGGT
GGTCTTGAGAC -> GTCTTGAGACT
GGTGAGCGGTT -> GTGAGCGGTTA
GGTGCCTGCCA -> GTGCCTGCCAT
GGTGCCTGTCT -> GTGCCTGTCTA
GGTGCGAGGGG -> GTGCGAGGGGC
GGTGCTGGGCC -> GTGCTGGGCCT
GGTGGGTCGCA -> GTGGGTCGCAT
GGTGGGTGCTG -> GTGGGTGCTGG
GGTGGTGAGCG -> GTGGTGAGCGG
GGTGTTGTCGG -> GTGTTGTCGGG
GGTTAAGATCC -> GTTAAGATCCA
GGTTCACGTAG -> GTTCACGTAGG
GGTTCCAAGTG -> GTTCCAAGTGC
GGTTGTTATTC -> GTTGTTATTCA
GTAAATATCAG -> TAAATATCAGT
GTAAATGTACG -> TAAATGTACGA
GTAACACGAGG -> TAACACGAGGG
GTAACCAACGT -> TAACCAACGTC
GTAACCCGGAT -> TAACCCGGATT
GTAACTGAACA -> TAACTGAACAC
GTAAGGACCCA -> TAAGGACCCAG
GTAAGGGCCGT -> TAAGGGCCGTA
GTACAAGCATC -> TACAAGCATCT
GTACACGTGCG -> TACACGTGCGA
GTACAGGCAGA -> TACAGGCAGAC
GTACATGCCAA -> TACATGCCAAC
GTACCCCAAGG -> TACCCCAAGGG
GTACCCTCTCA -> TACCCTCTCAT
GTACGAGGTGG -> TACGAGGTGGT
GTACGCGCGTA -> TACGCGCGTAC
GTACGGAGATA -> TACGGAGATAT
GTACGTGTGCC -> TACGTGTGCCT
GTAGACGCCTT -> TAGACGCCTTA
GTAGGACGACA -> TAGGACGACAC
GTATAACTATA -> TATAACTATAT
GTATCGCCTGA -> TATCGCCTGAG
GTATTTAGAGA -> TATTTAGAGAC
GTATTTCCGCA -> TATTTCCGCAC
GTCAACCTAAT -> TCAACCTAATC
GTCAAGGCACG -> TCAAGGCACGG
GTCAAGGTAAG -> TCAAGGTAAGG
GTCAATGCGGG -> TCAATGCGGGG
GTCACACGGTG -> TCACACGGTGC
GTCACCGGTCA -> TCACCGGTCAG
GTCACGGTCTT -> TCACGGTCTTG
GTCACTGGTGT -> TCACTGGTGTT
GTCAGAACCGC -> TCAGAACCGCA
GTCAGGTCCAA -> TCAGGTCCAAG
GTCAGTGACCT -> TCAGTGACCTG
GTCATCGCGAA -> TCATCGCGAAC
GTCATTCGCAA -> TCATTCGCAAA
GTCATTGAGCA -> TCATTGAGCAA
GTCCAAGTCGA -> TCCAAGTCGAT
GTCCACACAGC -> TCCACACAGCC
GTCCAGAGGGA -> TCCAGAGGGAG
GTCCGAATCCC -> TCCGAATCCCT
GTCCGGCTCTA -> TCCGGCTCTAT
GTCCTAGACTT -> TCCTAGACTTG
GTCCTATAACT -> TCCTATAACTC
GTCCTCCAACG -> TCCTCCAACGG
GTCCTGACCCA -> TCCTGACCCAT
GTCCTGAGTCA -> TCCTGAGTCAA,TCCTGAGTCAT
GTCGAATCAAA -> TCGAATCAAAA
GTCGATAGTAC -> TCGATAGTACA
GTCGCATTACC -> TCGCATTACCC
GTCGCTGTGTT -> TCGCTGTGTTA
GTCGGAAAACT -> TCGGAAAACTG
GTCGGGTTGTT -> TCGGGTTGTTA
GTCGTCGGAAA -> TCGTCGGAAAA
GTCGTCTCTTC -> TCGTCTCTTCA
GTCGTGTCCGG -> TCGTGTCCGGC
GTCGTTACCCG -> TCGTTACCCGT
GTCGTTGCCGG -> TCGTTGCCGGG
GTCTACCCCGG -> TCTACCCCGGC
GTCTATCTCCA -> TCTATCTCCAG
GTCTCACATAA -> TCTCACATAAT
GTCTCACGTCC -> TCTCACGTCCA
GTCTCTATACC -> TCTCTATACCG
GTCTCTTCAGG -> TCTCTTCAGGG
GTCTGGGGAAT -> TCTGGGGAATC
GTCTGGTGGGT -> TCTGGTGGGTC
GTCTGTGTGTA -> TCTGTGTGTAT
GTCTTGAGACT -> TCTTGAGACTC
GTGAACCTTGG -> TGAACCTTGGA
GTGAATATCGC -> TGAATATCGCG
GTGACCTGAGC -> TGACCTGAGCT
GTGACGGGGTC -> TGACGGGGTCC
GTGAGAGTTTC -> TGAGAGTTTCA
GTGAGCCGTCG -> TGAGCCGTCGT
GTGAGCGGTTA -> TGAGCGGTTAA
GTGCATCAGAG -> TGCATCAGAGT
GTGCCTCACAC -> TGCCTCACACC
GTGCCTGCCAT -> TGCCTGCCATT
GTGCCTGTCTA -> TGCCTGTCTAT
GTGCGAGGGGC -> TGCGAGGGGCA
GTGCGAGTCGA -> TGCGAGTCGAA
GTGCTGGGCCT -> TGCTGGGCCTT
GTGGAGCATTC -> TGGAGCATTCG
GTGGATATCGC -> TGGATATCGCA
GTGGCCATGCG -> TGGCCATGCGG
GTGGCGTACCC -> TGGCGTACCCT
GTGGGTCATTC -> TGGGTCATTCG
GTGGGTCGCAT -> TGGGTCGCATT
GTGGGTGCTGG -> TGGGTGCTGGG
GTGGTAACTGA -> TGGTAACTGAA
GTGGTGAGCGG -> TGGTGAGCGGT
GTGGTGCCTGT -> TGGTGCCTGTC
GTGTATCGCCT -> TGTATCGCCTG
GTGTATTTAGA -> TGTATTTAGAG
GTGTCAACCTA -> TGTCAACCTAA
GTGTCCGGCTC -> TGTCCGGCTCT
GTGTCCTGAGT -> TGTCCTGAGTC
GTGTGCCTCAC -> TGTGCCTCACA
GTGTGTATTTA -> TGTGTATTTAG
GTGTTAGGATC -> TGTTAGGATCG
GTGTTGGGGTC -> TGTTGGGGTCG
GTGTTGTCGGG -> TGTTGTCGGGT
GTTAAGAGCAG -> TTAAGAGCAGA
GTTAAGATCCA -> TTAAGATCCAA
GTTAAGATGGA -> TTAAGATGGAC
GTTAATCAAGA -> TTAATCAAGAT
GTTACAAAATA -> TTACAAAATAC
GTTACCCGTGG -> TTACCCGTGGC
GTTAGCCTCTT -> TTAGCCTCTTA
GTTAGGATCGA -> TTAGGATCGAG
GTTATTCACTG -> TTATTCACTGT
GTTCACGTAGG -> TTCACGTAGGA
GTTCACTCACA -> TTCACTCACAC
GTTCCAAGTGC -> TTCCAAGTGCA
GTTCGTGACGG -> TTCGTGACGGG
GTTCTGCAACG -> TTCTGCAACGA
GTTCTTACATC -> TTCTTACATCA
GTTGAATTGAG -> TTGAATTGAGT
GTTGACTCGAT -> TTGACTCGATT
GTTGCATAAGC -> TTGCATAAGCT
GTTGCCGGGAC -> TTGCCGGGACA
GTTGGGCCTTA -> TTGGGCCTTAG
GTTGGGGTCGT -> TTGGGGTCGTT
GTTGGTCTGGT -> TTGGTCTGGTG
GTTGTCGGGTT -> TTGTCGGGTTG
GTTGTGAATAT -> TTGTGAATATC
GTTGTGGTAAC -> TTGTGGTAACT
GTTGTTATTCA -> TTGTTATTCAC
GTTTCAAATTC -> TTTCAAATTCC
GTTTGGCTCCT -> TTTGGCTCCTC
TAAAACAGTAA -> AAAACAGTAAA
TAAAGAATCTA -> AAAGAATCTAC
TAAAGCGGCGA -> AAAGCGGCGAG
TAAATAGGGGC -> AAATAGGGGCC
TAAATATCAGT -> AAATATCAGTT
TAAATATTGAG -> AAATATTGAGA
TAAATGTACGA -> AAATGTACGAG
TAACACAAATC -> AACACAAATCT
TAACACGAGGG -> AACACGAGGGC
TAACCAACGTC -> AACCAACGTCG
TAACCAGTCTG -> AACCAGTCTGG
TAACCCGGATT -> AACCCGGATTG
TAACGTCTGTG -> AACGTCTGTGT
TAACTAGAATC -> AACTAGAATCC
TAACTATATGC -> AACTATATGCC
TAACTCACACT -> AACTCACACTC
TAACTGAACAC -> AACTGAACACG
TAAGAGCAGAT -> AAGAGCAGATT
TAAGAGTTCTG -> AAGAGTTCTGC
TAAGATCCAAA -> AAGATCCAAAT
TAAGATGGACA -> AAGATGGACAA
TAAGCTACGGC -> AAGCTACGGCT
TAAGGACCCAG -> AAGGACCCAGA
TAAGGGCCGTA -> AAGGGCCGTAC
TAATACTAGCA -> AATACTAGCAC
TAATAGACCCC -> AATAGACCCCG
TAATCAAGATG -> AATCAAGATGT
TAATCAGACTT -> AATCAGACTTA
TAATCTATTCA -> AATCTATTCAG
TAATGTCCTGA -> AATGTCCTGAG
TAATTGAATGA -> AATTGAATGAT
TAATTTGTGAG -> AATTTGTGAGC
TACAAAATACG -> ACAAAATACGC
TACAAGCACGT -> ACAAGCACGTT
TACAAGCATCT -> ACAAGCATCTT
TACACGTGCGA -> ACACGTGCGAG
TACAGGCAGAC -> ACAGGCAGACC
TACATCAAAGG -> ACATCAAAGGA
TACATGCCAAC -> ACATGCCAACC
TACCCCAAGGG -> ACCCCAAGGGA
TACCCCGCAGT -> ACCCCGCAGTT
TACCCCGGCTA -> ACCCCGGCTAC
TACCCGGTTCC -> ACCCGGTTCCA
TACCCGTGGCG -> ACCCGTGGCGT
TACCCTCTCAT -> ACCCTCTCATT
TACCGGCACAC -> ACCGGCACACT
TACCGTGTCAA -> ACCGTGTCAAC
TACCTACGCCC -> ACCTACGCCCC
TACGAGGTGGT -> ACGAGGTGGTG
TACGCCAACGT -> ACGCCAACGTC
TACGCCCCATG -> ACGCCCCATGT
TACGCGCGTAC -> ACGCGCGTACC
TACGGAGATAT -> ACGGAGATATC
TACGGCTAAGA -> ACGGCTAAGAG
TACGTATTTCC -> ACGTATTTCCG
TACGTGTGCCT -> ACGTGTGCCTC
TACTAGCACGC -> ACTAGCACGCC
TACTGGATCAT -> ACTGGATCATG
TACTGTGGAGC -> ACTGTGGAGCA
TAGAATCCCGG -> AGAATCCCGGA
TAGACCACTGT -> AGACCACTGTG
TAGACCCCGTT -> AGACCCCGTTG
TAGACGCCTTA -> AGACGCCTTAA
TAGACTTGTGT -> AGACTTGTGTT
TAGAGACGACG -> AGAGACGACGT
TAGCACGCCCG -> AGCACGCCCGA
TAGCCTCATCA -> AGCCTCATCAG
TAGCCTCTTAT -> AGCCTCTTATC
TAGGACGACAC -> AGGACGACACA
TAGGATCGAGA -> AGGATCGAGAA
TAGGCTTTATA -> AGGCTTTATAC
TAGGGGCCCGA -> AGGGGCCCGAC
TAGTACACGTG -> AGTACACGTGC
TAGTCCGAATC -> AGTCCGAATCC
TAGTGTATCGC -> AGTGTATCGCC
TATAACTATAT -> ATAACTATATG
TATAACTCACA -> ATAACTCACAC
TATACCGGCAC -> ATACCGGCACA
TATACCGTGTC -> ATACCGTGTCA
TATACGTATTT -> ATACGTATTTC
TATAGACCACT -> ATAGACCACTG
TATATGCCTGA -> ATATGCCTGAG
TATATTTGTGG -> ATATTTGTGGA
TATCAACTCGT -> ATCAACTCGTC
TATCAGTTAAG -> ATCAGTTAAGA
TATCCTTGACC -> ATCCTTGACCA
TATCGCACGTA -> ATCGCACGTAA
TATCGCCTGAG -> ATCGCCTGAGT
TATCGCGAAGC -> ATCGCGAAGCG
TATCTCCAGTT -> ATCTCCAGTTG
TATGAACAGGT -> ATGAACAGGTG
TATGCCTGAGA -> ATGCCTGAGAG
TATGGGAGACG -> ATGGGAGACGG
TATGTTAAGAT -> ATGTTAAGATG
TATTAACTAGA -> ATTAACTAGAA
TATTCACTGTC -> ATTCACTGTCA
TATTCAGCTTT -> ATTCAGCTTTC
TATTGAGATTG -> ATTGAGATTGG
TATTTAGAGAC -> ATTTAGAGACG
TATTTCCGCAC -> ATTTCCGCACA
TATTTGTGGAT -> ATTTGTGGATA
TCAAAAATGAA -> CAAAAATGAAC
TCAAACTCAGA -> CAAACTCAGAT
TCAAAGGATGT -> CAAAGGATGTC
TCAAATTCCAA -> CAAATTCCAAC
TCAACATCGAC -> CAACATCGACT
TCAACCTAATC -> CAACCTAATCA
TCAACTCGTCA -> CAACTCGTCAC
TCAAGATGTAC -> CAAGATGTACA
TCAAGGCACGG -> CAAGGCACGGT
TCAAGGTAAGG -> CAAGGTAAGGG
TCAATCTCACT -> CAATCTCACTC
TCAATGCGGGG -> CAATGCGGGGA
TCACACACGCC -> CACACACGCCT
TCACACCATAG -> CACACCATAGG
TCACACGGTGC -> CACACGGTGCC
TCACACTCAGC -> CACACTCAGCA
TCACAGGCCTT -> CACAGGCCTTT
TCACAGTCTCT -> CACAGTCTCTA
TCACATAATTG -> CACATAATTGA
TCACATTTTAT -> CACATTTTATG
TCACCGGTCAG -> CACCGGTCAGT
TCACGGTCTTG -> CACGGTCTTGA
TCACGTAGGAC -> CACGTAGGACG
TCACGTCCAGA -> CACGTCCAGAG
TCACTCACACA -> CACTCACACAC
TCACTGGTGTT -> CACTGGTGTTG
TCACTGTCACA -> CACTGTCACAC
TCACTTAAAGC -> CACTTAAAGCG
TCACTTGACGT -> CACTTGACGTG
TCAGAACCGCA -> CAGAACCGCAT
TCAGACTTATA -> CAGACTTATAG
TCAGAGTGAGA -> CAGAGTGAGAG
TCAGATCGGCT -> CAGATCGGCTC
TCAGCAATGTA -> CAGCAATGTAT
TCAGCCGCCAG -> CAGCCGCCAGG
TCAGCGGTCTC -> CAGCGGTCTCA
TCAGCTTTCCA -> CAGCTTTCCAC
TCAGGGGATCA -> CAGGGGATCAC
TCAGGTCCAAG -> CAGGTCCAAGT
TCAGTGACCTG -> CAGTGACCTGA
TCAGTTAAGAG -> CAGTTAAGAGC
TCAGTTCTTAC -> CAGTTCTTACA
TCATCAGTTCT -> CATCAGTTCTT
TCATCGCGAAC -> CATCGCGAACT
TCATCTGACAA -> CATCTGACAAG
TCATGATCTAT -> CATGATCTATT
TCATGGTAAGG -> CATGGTAAGGA
TCATGGTCAGA -> CATGGTCAGAA
TCATTAATGTC -> CATTAATGTCC
TCATTCGCAAA -> CATTCGCAAAG
TCATTGAGCAA -> CATTGAGCAAT
TCCAAATGAGA -> CCAAATGAGAA
TCCAACGATCG -> CCAACGATCGG
TCCAACGGAAC -> CCAACGGAACA
TCCAAGTCGAT -> CCAAGTCGATA
TCCAAGTGCAT -> CCAAGTGCATC
TCCACACAGCC -> CCACACAGCCA
TCCACGTTCAC -> CCACGTTCACT
TCCAGAGGGAG -> CCAGAGGGAGG
TCCAGTTGACT -> CCAGTTGACTC
TCCCAGTTGGT -> CCCAGTTGGTC
TCCCATAACAC -> CCCATAACACA
TCCCGGAGTCG -> CCCGGAGTCGT
TCCCTTCACAG -> CCCTTCACAGT
TCCGAATCCCT -> CCGAATCCCTT
TCCGCAATGAT -> CCGCAATGATA
TCCGCACATAG -> CCGCACATAGT
TCCGGCTCGTG -> CCGGCTCGTGG
TCCGGCTCTAT -> CCGGCTCTATA
TCCTAGACTTG -> CCTAGACTTGT
TCCTATAACTC -> CCTATAACTCA
TCCTCCAACGG -> CCTCCAACGGA
TCCTCTGCGGG -> CCTCTGCGGGG
TCCTGACCCAT -> CCTGACCCATT
TCCTGAGTCAA -> CCTGAGTCAAG
TCCTGAGTCAT -> CCTGAGTCATT
TCCTTGACCAG -> CCTTGACCAGT
TCGAATCAAAA -> CGAATCAAAAA
TCGACTTGCTA -> CGACTTGCTAA
TCGAGAATCGC -> CGAGAATCGCG
TCGAGACACAG -> CGAGACACAGT
TCGAGGCGCAA -> CGAGGCGCAAC
TCGATAGTACA -> CGATAGTACAC
TCGATTCAAAC -> CGATTCAAACT
TCGCAAAGAGG -> CGCAAAGAGGT
TCGCACGTAAC -> CGCACGTAACC
TCGCAGGCTAA -> CGCAGGCTAAT
TCGCATTACCC -> CGCATTACCCC
TCGCCAGCTTA -> CGCCAGCTTAA
TCGCCTGAGTT -> CGCCTGAGTTG
TCGCGAACTTT -> CGCGAACTTTG
TCGCGAAGCGT -> CGCGAAGCGTA
TCGCGCAGCCT -> CGCGCAGCCTA
TCGCTGTGTTA -> CGCTGTGTTAG
TCGGAAAACTG -> CGGAAAACTGT
TCGGCTCACAG -> CGGCTCACAGG
TCGGGCATAAA -> CGGGCATAAAA
TCGGGTTGTTA -> CGGGTTGTTAT
TCGTAACCCGG -> CGTAACCCGGA
TCGTCACCGGT -> CGTCACCGGTC
TCGTCGGAAAA -> CGTCGGAAAAC
TCGTCTCTTCA -> CGTCTCTTCAG
TCGTGACGGGG -> CGTGACGGGGT
TCGTGGCCATG -> CGTGGCCATGC
TCGTGGGTCAT -> CGTGGGTCATT
TCGTGTCCGGC -> CGTGTCCGGCT
TCGTTACCCGT -> CGTTACCCGTG
TCGTTGCCGGG -> CGTTGCCGGGA
TCGTTGTGAAT -> CGTTGTGAATA
TCTAAATATTG -> CTAAATATTGA
TCTACAAGCAC -> CTACAAGCACG
TCTACCCCGGC -> CTACCCCGGCT
TCTACTGGATC -> CTACTGGATCA
TCTATACCGTG -> CTATACCGTGT
TCTATACGTAT -> CTATACGTATT
TCTATCTCCAG -> CTATCTCCAGT
TCTATGAACAG -> CTATGAACAGG
TCTATTAACTA -> CTATTAACTAG
TCTATTCAGCT -> CTATTCAGCTT
TCTCACATAAT -> CTCACATAATT
TCTCACGTCCA -> CTCACGTCCAG
TCTCATTAATG -> CTCATTAATGT
TCTCCAGTTGA -> CTCCAGTTGAC
TCTCCGCAATG -> CTCCGCAATGA
TCTCTATACCG -> CTCTATACCGT
TCTCTTCAGGG -> CTCTTCAGGGG
TCTCTTCATCT -> CTCTTCATCTG
TCTGACAAGAT -> CTGACAAGATC
TCTGCAACGAC -> CTGCAACGACG
TCTGCGGGGCA -> CTGCGGGGCAA
TCTGGGGAACT -> CTGGGGAACTG
TCTGGGGAATC -> CTGGGGAATCC
TCTGGTGGGTC -> CTGGTGGGTCG
TCTGTGTGTAT -> CTGTGTGTATT
TCTTACATCAA -> CTTACATCAAA
TCTTATCAACT -> CTTATCAACTC
TCTTCAGGGGA -> CTTCAGGGGAT
TCTTCATCTGA -> CTTCATCTGAC
TCTTCTAAATA -> CTTCTAAATAT
TCTTCTTTGAG -> CTTCTTTGAGA
TCTTGAGACTC -> CTTGAGACTCA
TCTTTGAGAGT -> CTTTGAGAGTA
TGAACACGGCC -> GAACACGGCCG
TGAACAGGTGG -> GAACAGGTGGG
TGAACCTTGAC -> GAACCTTGACA
TGAACCTTGGA -> GAACCTTGGAG
TGAATATCGCG -> GAATATCGCGA
TGAATGATGAT -> GAATGATGATG
TGAATTGAGTC -> GAATTGAGTCG
TGACAAGATCT -> GACAAGATCTA
TGACAGACTTA -> GACAGACTTAA
TGACCAGTACA -> GACCAGTACAG
TGACCCATTTA -> GACCCATTTAA
TGACCTGAGCT -> GACCTGAGCTG
TGACGGGGCCT -> GACGGGGCCTC
TGACGGGGTCC -> GACGGGGTCCA
TGACGTGGTGC -> GACGTGGTGCC
TGACTCGATTC -> GACTCGATTCA
TGAGAAAAAAA -> GAGAAAAAAAA
TGAGACTCAAC -> GAGACTCAACA
TGAGAGCGAAT -> GAGAGCGAATT
TGAGAGTACGT -> GAGAGTACGTG
TGAGAGTTTCA -> GAGAGTTTCAA
TGAGATTGGTC -> GAGATTGGTCT
TGAGCAATCAG -> GAGCAATCAGC
TGAGCCATCAA -> GAGCCATCAAT
TGAGCCGTCGT -> GAGCCGTCGTC
TGAGCGGCCAC -> GAGCGGCCACC
TGAGCGGTTAA -> GAGCGGTTAAG
TGAGCTGCTAA -> GAGCTGCTAAT
TGAGTCAAGGC -> GAGTCAAGGCA
TGAGTCATTGA -> GAGTCATTGAG
TGAGTCGTGTC -> GAGTCGTGTCC
TGAGTTGGGCC -> GAGTTGGGCCT
TGATATGTTAA -> GATATGTTAAG
TGATCATGATC -> GATCATGATCT
TGATCTATTAA -> GATCTATTAAC
TGATGATGTTG -> GATGATGTTGT
TGATGTTGTGG -> GATGTTGTGGT
TGATTCGAGAC -> GATTCGAGACA
TGCAACGACGG -> GCAACGACGGT
TGCATAAGCTA -> GCATAAGCTAC
TGCATCAGAGT -> GCATCAGAGTG
TGCCAACCCGA -> GCCAACCCGAC
TGCCATTGGAA -> GCCATTGGAAG
TGCCGGGACAA -> GCCGGGACAAT
TGCCTCACACC -> GCCTCACACCA
TGCCTGAGAGC -> GCCTGAGAGCG
TGCCTGCCATT -> GCCTGCCATTG
TGCCTGTCTAT -> GCCTGTCTATC
TGCGAGGGGCA -> GCGAGGGGCAG
TGCGAGTCGAA -> GCGAGTCGAAT
TGCGGCATTTC -> GCGGCATTTCG
TGCGGCGCGCA -> GCGGCGCGCAA
TGCGGGGAGGC -> GCGGGGAGGCA
TGCGGGGCAAA -> GCGGGGCAAAA
TGCTAATAGAC -> GCTAATAGACC
TGCTAATCTAT -> GCTAATCTATT
TGCTCCCAGTT -> GCTCCCAGTTG
TGCTGGGCCTT -> GCTGGGCCTTT
TGGAAGTTAAT -> GGAAGTTAATC
TGGACAATTTC -> GGACAATTTCT
TGGAGAAGGAC -> GGAGAAGGACA
TGGAGCATTCG -> GGAGCATTCGC
TGGATATCGCA -> GGATATCGCAC
TGGATCATGGT -> GGATCATGGTA
TGGCCATGCGG -> GGCCATGCGGC
TGGCGTACCCT -> GGCGTACCCTC
TGGCTCCTCTG -> GGCTCCTCTGC
TGGCTCGCCAG -> GGCTCGCCAGC
TGGGAGACGGC -> GGGAGACGGCC
TGGGCATCTGG -> GGGCATCTGGG
TGGGCCTTAGC -> GGGCCTTAGCC
TGGGCCTTTCA -> GGGCCTTTCAG
TGGGGAACTGC -> GGGGAACTGCT
TGGGGAATCCC -> GGGGAATCCCA
TGGGGTCGTTA -> GGGGTCGTTAC
TGGGTCATTCG -> GGGTCATTCGC
TGGGTCGCATT -> GGGTCGCATTA
TGGGTGCTGGG -> GGGTGCTGGGC
TGGTAACTGAA -> GGTAACTGAAC
TGGTAAGGACC -> GGTAAGGACCC
TGGTCAGAACC -> GGTCAGAACCG
TGGTCAGGTCC -> GGTCAGGTCCA
TGGTCTCACAT -> GGTCTCACATA
TGGTCTGGTGG -> GGTCTGGTGGG
TGGTGAGCGGT -> GGTGAGCGGTT
TGGTGCCTGTC -> GGTGCCTGTCT
TGGTGCGAGGG -> GGTGCGAGGGG
TGGTGGGTCGC -> GGTGGGTCGCA
TGGTGTTGTCG -> GGTGTTGTCGG
TGTACATGCCA -> GTACATGCCAA
TGTACGAGGTG -> GTACGAGGTGG
TGTACGCGCGT -> GTACGCGCGTA
TGTATAACTAT -> GTATAACTATA
TGTATCGCCTG -> GTATCGCCTGA
TGTATTTAGAG -> GTATTTAGAGA
TGTCAACCTAA -> GTCAACCTAAT
TGTCAATGCGG -> GTCAATGCGGG
TGTCACACGGT -> GTCACACGGTG
TGTCCGGCTCT -> GTCCGGCTCTA
TGTCCTCCAAC -> GTCCTCCAACG
TGTCCTGACCC -> GTCCTGACCCA
TGTCCTGAGTC -> GTCCTGAGTCA,GTCCTGAGTCA
TGTCGGGTTGT -> GTCGGGTTGTT
TGTCTATCTCC -> GTCTATCTCCA
TGTGAACCTTG -> GTGAACCTTGG
TGTGAATATCG -> GTGAATATCGC
TGTGAGCCGTC -> GTGAGCCGTCG
TGTGCCTCACA -> GTGCCTCACAC
TGTGGAGCATT -> GTGGAGCATTC
TGTGGATATCG -> GTGGATATCGC
TGTGGTAACTG -> GTGGTAACTGA
TGTGTATTTAG -> GTGTATTTAGA
TGTGTCCTGAG -> GTGTCCTGAGT
TGTGTGTATTT -> GTGTGTATTTA
TGTGTTAGGAT -> GTGTTAGGATC
TGTGTTGGGGT -> GTGTTGGGGTC
TGTTAAGATGG -> GTTAAGATGGA
TGTTAGGATCG -> GTTAGGATCGA
TGTTATTCACT -> GTTATTCACTG
TGTTGGGGTCG -> GTTGGGGTCGT
TGTTGTCGGGT -> GTTGTCGGGTT
TGTTGTGGTAA -> GTTGTGGTAAC
TTAAAGAATCT -> TAAAGAATCTA
TTAAAGCGGCG -> TAAAGCGGCGA
TTAAATAGGGG -> TAAATAGGGGC
TTAACCAGTCT -> TAACCAGTCTG
TTAACGTCTGT -> TAACGTCTGTG
TTAACTAGAAT -> TAACTAGAATC
TTAAGAGCAGA -> TAAGAGCAGAT
TTAAGATCCAA -> TAAGATCCAAA
TTAAGATGGAC -> TAAGATGGACA
TTAATACTAGC -> TAATACTAGCA
TTAATCAAGAT -> TAATCAAGATG
TTAATGTCCTG -> TAATGTCCTGA
TTACAAAATAC -> TACAAAATACG
TTACATCAAAG -> TACATCAAAGG
TTACCCCGCAG -> TACCCCGCAGT
TTACCCGTGGC -> TACCCGTGGCG
TTAGAGACGAC -> TAGAGACGACG
TTAGCCTCATC -> TAGCCTCATCA
TTAGCCTCTTA -> TAGCCTCTTAT
TTAGGATCGAG -> TAGGATCGAGA
TTATACCGGCA -> TATACCGGCAC
TTATAGACCAC -> TATAGACCACT
TTATCAACTCG -> TATCAACTCGT
TTATGGGAGAC -> TATGGGAGACG
TTATTCACTGT -> TATTCACTGTC
TTCAAACTCAG -> TCAAACTCAGA
TTCAAATTCCA -> TCAAATTCCAA
TTCACAGTCTC -> TCACAGTCTCT
TTCACGTAGGA -> TCACGTAGGAC
TTCACTCACAC -> TCACTCACACA
TTCACTGTCAC -> TCACTGTCACA
TTCACTTGACG -> TCACTTGACGT
TTCAGCGGTCT -> TCAGCGGTCTC
TTCAGCTTTCC -> TCAGCTTTCCA
TTCAGGGGATC -> TCAGGGGATCA
TTCATCTGACA -> TCATCTGACAA
TTCCAACGATC -> TCCAACGATCG
TTCCAAGTGCA -> TCCAAGTGCAT
TTCCACGTTCA -> TCCACGTTCAC
TTCCGCACATA -> TCCGCACATAG
TTCCGGCTCGT -> TCCGGCTCGTG
TTCGAGACACA -> TCGAGACACAG
TTCGCAAAGAG -> TCGCAAAGAGG
TTCGCAGGCTA -> TCGCAGGCTAA
TTCGTGACGGG -> TCGTGACGGGG
TTCGTTGTGAA -> TCGTTGTGAAT
TTCTAAATATT -> TCTAAATATTG
TTCTCTTCATC -> TCTCTTCATCT
TTCTGCAACGA -> TCTGCAACGAC
TTCTTACATCA -> TCTTACATCAA
TTCTTTGAGAG -> TCTTTGAGAGT
TTGAATGATGA -> TGAATGATGAT
TTGAATTGAGT -> TGAATTGAGTC
TTGACAGACTT -> TGACAGACTTA
TTGACCAGTAC -> TGACCAGTACA
TTGACGTGGTG -> TGACGTGGTGC
TTGACTCGATT -> TGACTCGATTC
TTGAGACTCAA -> TGAGACTCAAC
TTGAGAGTACG -> TGAGAGTACGT
TTGAGATTGGT -> TGAGATTGGTC
TTGAGCAATCA -> TGAGCAATCAG
TTGAGCGGCCA -> TGAGCGGCCAC
TTGAGTCGTGT -> TGAGTCGTGTC
TTGCATAAGCT -> TGCATAAGCTA
TTGCCGGGACA -> TGCCGGGACAA
TTGCTAATCTA -> TGCTAATCTAT
TTGGAAGTTAA -> TGGAAGTTAAT
TTGGAGAAGGA -> TGGAGAAGGAC
TTGGCTCCTCT -> TGGCTCCTCTG
TTGGGCCTTAG -> TGGGCCTTAGC
TTGGGGTCGTT -> TGGGGTCGTTA
TTGGTCTCACA -> TGGTCTCACAT
TTGGTCTGGTG -> TGGTCTGGTGG
TTGGTGCGAGG -> TGGTGCGAGGG
TTGTACGCGCG -> TGTACGCGCGT
TTGTCGGGTTG -> TGTCGGGTTGT
TTGTGAATATC -> TGTGAATATCG
TTGTGAGCCGT -> TGTGAGCCGTC
TTGTGGATATC -> TGTGGATATCG
TTGTGGTAACT -> TGTGGTAACTG
TTGTGTTGGGG -> TGTGTTGGGGT
TTGTTATTCAC -> TGTTATTCACT
TTTAATACTAG -> TTAATACTAGC
TTTAGAGACGA -> TTAGAGACGAC
TTTATACCGGC -> TTATACCGGCA
TTTATGGGAGA -> TTATGGGAGAC
TTTCAAATTCC -> TTCAAATTCCA
TTTCAGCGGTC -> TTCAGCGGTCT
TTTCCACGTTC -> TTCCACGTTCA
TTTCCGCACAT -> TTCCGCACATA
TTTCCGGCTCG -> TTCCGGCTCGT
TTTCGTTGTGA -> TTCGTTGTGAA
TTTCTCTTCAT -> TTCTCTTCATC
TTTGAGAGTAC -> TTGAGAGTACG
TTTGGCTCCTC -> TTGGCTCCTCT
TTTGGTGCGAG -> TTGGTGCGAGG
TTTGTGAGCCG -> TTGTGAGCCGT
TTTGTGGATAT -> TTGTGGATATC
TTTTATGGGAG -> TTTATGGGAGA
