AAAAATCTTCACACGATCA -> AAAATCTTCACACGATCAC
AAAACTATTCATCCAGGTC -> AAACTATTCATCCAGGTCC
AAAAGCTTGCAACTGTCGC -> AAAGCTTGCAACTGTCGCA
AAAATCAATTCTGTTCAGA -> AAATCAATTCTGTTCAGAG
AAAATCTTCACACGATCAC -> AAATCTTCACACGATCACT
AAAATGTCTCAGCGAGGGT -> AAATGTCTCAGCGAGGGTA
AAAATTATTCCAGGCGGTC -> AAATTATTCCAGGCGGTCT
AAACAGTTGCCCTTGTTAA -> AACAGTTGCCCTTGTTAAT
AAACATTGTGAACCTACGC -> AACATTGTGAACCTACGCG
AAACGACAAAGCTCCAAGC -> AACGACAAAGCTCCAAGCA
AAACGGAGCACTGAAGCAA -> AACGGAGCACTGAAGCAAT
AAACTATTCATCCAGGTCC -> AACTATTCATCCAGGTCCT
AAAGCCCAGCCATTTGGGT -> AAGCCCAGCCATTTGGGTA
AAAGCGCGTTAAGTAGCTC -> AAGCGCGTTAAGTAGCTCT
AAAGCTCCAAGCAGGAGTG -> AAGCTCCAAGCAGGAGTGG
AAAGCTCCTATCCGTTATG -> AAGCTCCTATCCGTTATGG
AAAGCTTGCAACTGTCGCA -> AAGCTTGCAACTGTCGCAA
AAAGGAACGCGCGCGCTAA -> AAGGAACGCGCGCGCTAAT
AAAGGGACCGGGATAGGAC -> AAGGGACCGGGATAGGACA
AAAGTCGGGTGTTCGCCCG -> AAGTCGGGTGTTCGCCCGC
AAAGTCTTCCATATTGTCC -> AAGTCTTCCATATTGTCCT
AAAGTGCGACATAAGGCGG -> AAGTGCGACATAAGGCGGT
AAATAATCCACAAAGTCGG -> AATAATCCACAAAGTCGGG
AAATACGACCATTTCCACC -> AATACGACCATTTCCACCT
AAATCAATTCTGTTCAGAG -> AATCAATTCTGTTCAGAGG
AAATCCCGTAATGCTAAAT -> AATCCCGTAATGCTAAATT
AAATCTCATTTTTAAACAT -> AATCTCATTTTTAAACATT
AAATCTTCACACGATCACT -> AATCTTCACACGATCACTA
AAATGTCTCAGCGAGGGTA -> AATGTCTCAGCGAGGGTAT
AAATGTGGCTGGCATCAGC -> AATGTGGCTGGCATCAGCC
AAATTATTCCAGGCGGTCT -> AATTATTCCAGGCGGTCTC
AAATTCTTAACAGCGCGGA -> AATTCTTAACAGCGCGGAT
AAATTTAGCGAGAGAAGCG -> AATTTAGCGAGAGAAGCGG
AACAAAGCTCCTATCCGTT -> ACAAAGCTCCTATCCGTTA
AACAAATCTCATTTTTAAA -> ACAAATCTCATTTTTAAAC
AACAATACCGTTCGTTGTG -> ACAATACCGTTCGTTGTGA
AACAATCGGTTGACCTCTA -> ACAATCGGTTGACCTCTAA
AACACGAGACCAATCGTTG -> ACACGAGACCAATCGTTGG
AACACTTGGAGGTGAGAGA -> ACACTTGGAGGTGAGAGAA
AACAGAGAACAAAGCTCCT -> ACAGAGAACAAAGCTCCTA
AACAGCGCGGATCCAGGAG -> ACAGCGCGGATCCAGGAGT
AACAGTGGTATGTCAGCTG -> ACAGTGGTATGTCAGCTGT
AACAGTTGCCCTTGTTAAT -> ACAGTTGCCCTTGTTAATC
AACATGCAGGCCATATAAC -> ACATGCAGGCCATATAACC
AACATGGGGAAGTAACTGA -> ACATGGGGAAGTAACTGAG
AACATTACTCTTAGAGACT -> ACATTACTCTTAGAGACTA
AACATTGTGAACCTACGCG -> ACATTGTGAACCTACGCGA
AACCAACCGGACTGGGGCT -> ACCAACCGGACTGGGGCTC
AACCGGACTGGGGCTCCTC -> ACCGGACTGGGGCTCCTCC
AACCGGTAATTATAGGGTC -> ACCGGTAATTATAGGGTCA
AACCGTTAAATGTGGCTGG -> ACCGTTAAATGTGGCTGGC
AACCTAACAGAGAACAAAG -> ACCTAACAGAGAACAAAGC
AACCTACGCGATCAACTTA -> ACCTACGCGATCAACTTAT
AACGACAAAGCTCCAAGCA -> ACGACAAAGCTCCAAGCAG
AACGCGCGCGCTAATAGCT -> ACGCGCGCGCTAATAGCTC
AACGGAACTGGGGGAACCA -> ACGGAACTGGGGGAACCAA
AACGGAGCACTGAAGCAAT -> ACGGAGCACTGAAGCAATG
AACGGCACTAAATCCCGTA -> ACGGCACTAAATCCCGTAA
AACTAGGCGGCGCAGAAAG -> ACTAGGCGGCGCAGAAAGT
AACTATTCATCCAGGTCCT -> ACTATTCATCCAGGTCCTG
AACTGAGATACAGATACCT -> ACTGAGATACAGATACCTG
AACTGGGGGAACCAACCGG -> ACTGGGGGAACCAACCGGA
AACTGTCGCAAATTTAGCG -> ACTGTCGCAAATTTAGCGA
AACTTATAACGGAACTGGG -> ACTTATAACGGAACTGGGG
AACTTGTTGACGACTTTCG -> ACTTGTTGACGACTTTCGA
AAGAAAAGCTTGCAACTGT -> AGAAAAGCTTGCAACTGTC
AAGAGGGAGCTATCCAGAT -> AGAGGGAGCTATCCAGATG
AAGATAGTATTTGCCCGGA -> AGATAGTATTTGCCCGGAA
AAGATATTATAGGTATTCT -> AGATATTATAGGTATTCTT
AAGATGAAGATAGTATTTG -> AGATGAAGATAGTATTTGC
AAGATGGGCCGGAATGCGA -> AGATGGGCCGGAATGCGAG
AAGCAATGCTTGGCGCAGG -> AGCAATGCTTGGCGCAGGT
AAGCACTGTGTATCACATG -> AGCACTGTGTATCACATGT
AAGCAGGAGTGGAGGTTAC -> AGCAGGAGTGGAGGTTACA
AAGCCCAGCCATTTGGGTA -> AGCCCAGCCATTTGGGTAC
AAGCCCCGTTCGTTGAGTA -> AGCCCCGTTCGTTGAGTAA
AAGCGCGTTAAGTAGCTCT -> AGCGCGTTAAGTAGCTCTT
AAGCGGTGTCGGCACCAGA -> AGCGGTGTCGGCACCAGAC
AAGCTCCAAGCAGGAGTGG -> AGCTCCAAGCAGGAGTGGA
AAGCTCCCGGGGTGCCTGG -> AGCTCCCGGGGTGCCTGGA
AAGCTCCTATCCGTTATGG -> AGCTCCTATCCGTTATGGA
AAGCTTGCAACTGTCGCAA -> AGCTTGCAACTGTCGCAAA
AAGGAACGCGCGCGCTAAT -> AGGAACGCGCGCGCTAATA
AAGGCGAAGGTAATGCAGG -> AGGCGAAGGTAATGCAGGA
AAGGCGGACATAAGTCGCG -> AGGCGGACATAAGTCGCGC
AAGGCGGTCATCCTAAACA -> AGGCGGTCATCCTAAACAG
AAGGGACCGGGATAGGACA -> AGGGACCGGGATAGGACAT
AAGGGATTATACCACTTAT -> AGGGATTATACCACTTATA
AAGGTAATGCAGGAATGAA -> AGGTAATGCAGGAATGAAC
AAGGTCCGCCCGATGCCCT -> AGGTCCGCCCGATGCCCTG
AAGGTGGTCGTAGGCCACT -> AGGTGGTCGTAGGCCACTG
AAGTAACTGAGATACAGAT -> AGTAACTGAGATACAGATA
AAGTAGATCATCGGATCGA -> AGTAGATCATCGGATCGAT
AAGTAGCTCTTTGCACAAA -> AGTAGCTCTTTGCACAAAA
AAGTCACAGAGCCCACCAA -> AGTCACAGAGCCCACCAAG
AAGTCAGCGGCAGACGCGG -> AGTCAGCGGCAGACGCGGT
AAGTCGCGCTCAAAGCGCG -> AGTCGCGCTCAAAGCGCGT
AAGTCGGGTGTTCGCCCGC -> AGTCGGGTGTTCGCCCGCA
AAGTCTTCCATATTGTCCT -> AGTCTTCCATATTGTCCTT
AAGTGCGACATAAGGCGGT -> AGTGCGACATAAGGCGGTC
AAGTTAGTGAGAGTGCTGG -> AGTTAGTGAGAGTGCTGGT
AAGTTTATGCTTGTGTTTG -> AGTTTATGCTTGTGTTTGG
AATAACACGAGACCAATCG -> ATAACACGAGACCAATCGT
AATAATCCACAAAGTCGGG -> ATAATCCACAAAGTCGGGT
AATACCCAGGCTCACCTAA -> ATACCCAGGCTCACCTAAC
AATACCGTTCGTTGTGAGA -> ATACCGTTCGTTGTGAGAG
AATACGACCATTTCCACCT -> ATACGACCATTTCCACCTA
AATACGAGGGGAAGATGAA -> ATACGAGGGGAAGATGAAG
AATACGGTAAGATGGGCCG -> ATACGGTAAGATGGGCCGG
AATAGAAAAATCTTCACAC -> ATAGAAAAATCTTCACACG
AATAGAGGTACTGGTTTAG -> ATAGAGGTACTGGTTTAGG
AATAGCCCAGTACAACCTA -> ATAGCCCAGTACAACCTAA
AATAGCTCCCGGGGTGCCT -> ATAGCTCCCGGGGTGCCTG
AATAGGTATCTTCATAAGG -> ATAGGTATCTTCATAAGGT
AATAGTACAGGTCTTCTAC -> ATAGTACAGGTCTTCTACA
AATAGTCCCGAAATACGAC -> ATAGTCCCGAAATACGACC
AATATCCGGGGCGTACTGC -> ATATCCGGGGCGTACTGCG
AATCAATTCTGTTCAGAGG -> ATCAATTCTGTTCAGAGGG
AATCCACAAAGTCGGGTGT -> ATCCACAAAGTCGGGTGTT
AATCCCGTAATGCTAAATT -> ATCCCGTAATGCTAAATTC
AATCGCAATAGGTATCTTC -> ATCGCAATAGGTATCTTCA
AATCGGTTGACCTCTAAAC -> ATCGGTTGACCTCTAAACG
AATCGTCTCCAGACGTAGC -> ATCGTCTCCAGACGTAGCG
AATCGTTGGATGTAGCTCG -> ATCGTTGGATGTAGCTCGT
AATCTCATTTTTAAACATT -> ATCTCATTTTTAAACATTG
AATCTTCACACGATCACTA -> ATCTTCACACGATCACTAA
AATGAACAAATCTCATTTT -> ATGAACAAATCTCATTTTT
AATGAACAATCGGTTGACC -> ATGAACAATCGGTTGACCT
AATGAACATGGGGAAGTAA -> ATGAACATGGGGAAGTAAC
AATGAACATTACTCTTAGA -> ATGAACATTACTCTTAGAG
AATGATAATATCCGGGGCG -> ATGATAATATCCGGGGCGT
AATGCAGGAATGAACAAAT -> ATGCAGGAATGAACAAATC
AATGCAGGAATGAACAATC -> ATGCAGGAATGAACAATCG
AATGCAGGAATGAACATGG -> ATGCAGGAATGAACATGGG
AATGCAGGAATGAACATTA -> ATGCAGGAATGAACATTAC
AATGCGAGACTTTATATTT -> ATGCGAGACTTTATATTTT
AATGCTAAATTCTTAACAG -> ATGCTAAATTCTTAACAGC
AATGCTTGGCGCAGGTATC -> ATGCTTGGCGCAGGTATCA
AATGTAATGTTCAGTATAA -> ATGTAATGTTCAGTATAAG
AATGTCTCAGCGAGGGTAT -> ATGTCTCAGCGAGGGTATT
AATGTGGCTGGCATCAGCC -> ATGTGGCTGGCATCAGCCC
AATGTTCAGTATAAGTTTA -> ATGTTCAGTATAAGTTTAT
AATTAAGTCACAGAGCCCA -> ATTAAGTCACAGAGCCCAC
AATTACTTACACCGCGTTA -> ATTACTTACACCGCGTTAA
AATTATAGGGTCATTGCGG -> ATTATAGGGTCATTGCGGA
AATTATTCCAGGCGGTCTC -> ATTATTCCAGGCGGTCTCG
AATTCGACTGGGAATAGAA -> ATTCGACTGGGAATAGAAA
AATTCTGTTCAGAGGGCGC -> ATTCTGTTCAGAGGGCGCC
AATTCTTAACAGCGCGGAT -> ATTCTTAACAGCGCGGATC
AATTGAGCTTCTACCCGCT -> ATTGAGCTTCTACCCGCTA
AATTTAGCGAGAGAAGCGG -> ATTTAGCGAGAGAAGCGGT
ACAAAATCAATTCTGTTCA -> CAAAATCAATTCTGTTCAG
ACAAAGCCCAGCCATTTGG -> CAAAGCCCAGCCATTTGGG
ACAAAGCTCCAAGCAGGAG -> CAAAGCTCCAAGCAGGAGT
ACAAAGCTCCTATCCGTTA -> CAAAGCTCCTATCCGTTAT
ACAAAGGAACGCGCGCGCT -> CAAAGGAACGCGCGCGCTA
ACAAAGTCGGGTGTTCGCC -> CAAAGTCGGGTGTTCGCCC
ACAAATCTCATTTTTAAAC -> CAAATCTCATTTTTAAACA
ACAACCTAACAGAGAACAA -> CAACCTAACAGAGAACAAA
ACAAGAAAAGCTTGCAACT -> CAAGAAAAGCTTGCAACTG
ACAAGTAGATCATCGGATC -> CAAGTAGATCATCGGATCG
ACAATACCGTTCGTTGTGA -> CAATACCGTTCGTTGTGAG
ACAATCGGTTGACCTCTAA -> CAATCGGTTGACCTCTAAA
ACACCGCGTTAATACGAGG -> CACCGCGTTAATACGAGGG
ACACGAGACCAATCGTTGG -> CACGAGACCAATCGTTGGA
ACACGATCACTAACTAGGC -> CACGATCACTAACTAGGCG
ACACTTGGAGGTGAGAGAA -> CACTTGGAGGTGAGAGAAA
ACAGAGAACAAAGCTCCTA -> CAGAGAACAAAGCTCCTAT
ACAGAGCCCACCAAGCCCC -> CAGAGCCCACCAAGCCCCG
ACAGATACCTGGATACTGT -> CAGATACCTGGATACTGTG
ACAGCGCGGATCCAGGAGT -> CAGCGCGGATCCAGGAGTG
ACAGGTCTTCTACAAAGGA -> CAGGTCTTCTACAAAGGAA
ACAGTGGTATGTCAGCTGT -> CAGTGGTATGTCAGCTGTA
ACAGTTGCCCTTGTTAATC -> CAGTTGCCCTTGTTAATCG
ACATAAGGCGGTCATCCTA -> CATAAGGCGGTCATCCTAA
ACATAAGTCGCGCTCAAAG -> CATAAGTCGCGCTCAAAGC
ACATAGTGGTAATGCAGGA -> CATAGTGGTAATGCAGGAA
ACATCCGTGCACCACCAGT -> CATCCGTGCACCACCAGTG
ACATGCAGGCCATATAACC -> CATGCAGGCCATATAACCG
ACATGGGGAAGTAACTGAG -> CATGGGGAAGTAACTGAGA
ACATGTGGGGAATAGCCCA -> CATGTGGGGAATAGCCCAG
ACATTACTCTTAGAGACTA -> CATTACTCTTAGAGACTAT
ACATTCCTTGGTTCGTTTA -> CATTCCTTGGTTCGTTTAA
ACATTGTGAACCTACGCGA -> CATTGTGAACCTACGCGAT
ACCAACCGGACTGGGGCTC -> CCAACCGGACTGGGGCTCC
ACCAAGCCCCGTTCGTTGA -> CCAAGCCCCGTTCGTTGAG
ACCAATCGTTGGATGTAGC -> CCAATCGTTGGATGTAGCT
ACCACCAGTGAGACCCCGG -> CCACCAGTGAGACCCCGGG
ACCACTTATAGTACTGCGG -> CCACTTATAGTACTGCGGT
ACCAGACGGCTGCATGGGT -> CCAGACGGCTGCATGGGTT
ACCAGTGAGACCCCGGGTG -> CCAGTGAGACCCCGGGTGC
ACCATGAGATAGTGCCAGC -> CCATGAGATAGTGCCAGCG
ACCATTTCCACCTAATCGC -> CCATTTCCACCTAATCGCA
ACCCAGGCTCACCTAACAA -> CCCAGGCTCACCTAACAAT
ACCCCGGGTGCAATACCCA -> CCCCGGGTGCAATACCCAG
ACCCGCTAAGCACTGTGTA -> CCCGCTAAGCACTGTGTAT
ACCGCGTTAATACGAGGGG -> CCGCGTTAATACGAGGGGA
ACCGGACTGGGGCTCCTCC -> CCGGACTGGGGCTCCTCCT
ACCGGGATAGGACATCCGT -> CCGGGATAGGACATCCGTG
ACCGGTAATTATAGGGTCA -> CCGGTAATTATAGGGTCAT
ACCGTTAAATGTGGCTGGC -> CCGTTAAATGTGGCTGGCA
ACCGTTCGTTGTGAGAGTC -> CCGTTCGTTGTGAGAGTCA
ACCTAACAATACCGTTCGT -> CCTAACAATACCGTTCGTT
ACCTAACAGAGAACAAAGC -> CCTAACAGAGAACAAAGCT
ACCTAATCGCAATAGGTAT -> CCTAATCGCAATAGGTATC
ACCTACGCGATCAACTTAT -> CCTACGCGATCAACTTATA
ACCTCAAAGTCTTCCATAT -> CCTCAAAGTCTTCCATATT
ACCTCGATATGAGGTCCTT -> CCTCGATATGAGGTCCTTC
ACCTCTAAACGACAAAGCT -> CCTCTAAACGACAAAGCTC
ACCTCTTGTCCTAAAATTA -> CCTCTTGTCCTAAAATTAT
ACCTGGATACTGTGCTGGT -> CCTGGATACTGTGCTGGTA
ACCTGTCGAGCTCCCGGGG -> CCTGTCGAGCTCCCGGGGT
ACCTTAACATGCAGGCCAT -> CCTTAACATGCAGGCCATA
ACGACAAAGCTCCAAGCAG -> CGACAAAGCTCCAAGCAGG
ACGACCATTTCCACCTAAT -> CGACCATTTCCACCTAATC
ACGACTTTCGAATAGTCCC -> CGACTTTCGAATAGTCCCG
ACGAGACCAATCGTTGGAT -> CGAGACCAATCGTTGGATG
ACGAGGGGAAGATGAAGAT -> CGAGGGGAAGATGAAGATA
ACGATCACTAACTAGGCGG -> CGATCACTAACTAGGCGGC
ACGCATGGGTGGAATTCGA -> CGCATGGGTGGAATTCGAC
ACGCCATCAGAAGATATTA -> CGCCATCAGAAGATATTAT
ACGCCCGCTTGGTAATGCA -> CGCCCGCTTGGTAATGCAG
ACGCGATCAACTTATAACG -> CGCGATCAACTTATAACGG
ACGCGCGCGCTAATAGCTC -> CGCGCGCGCTAATAGCTCC
ACGCGGTTGTTCCAATTGA -> CGCGGTTGTTCCAATTGAG
ACGGAACTGGGGGAACCAA -> CGGAACTGGGGGAACCAAC
ACGGAGCACTGAAGCAATG -> CGGAGCACTGAAGCAATGC
ACGGCACTAAATCCCGTAA -> CGGCACTAAATCCCGTAAT
ACGGCGTCATAAGAGGGAG -> CGGCGTCATAAGAGGGAGC
ACGGCTGCATGGGTTATGA -> CGGCTGCATGGGTTATGAT
ACGGTAAGATGGGCCGGAA -> CGGTAAGATGGGCCGGAAT
ACGTAGCGGTTTGGTAAAA -> CGTAGCGGTTTGGTAAAAT
ACGTAGTGGAAGGCGGACA -> CGTAGTGGAAGGCGGACAT
ACGTCACGTAGTGGAAGGC -> CGTCACGTAGTGGAAGGCG
ACGTCGCAGCGAATTACTT -> CGTCGCAGCGAATTACTTA
ACTAAATCCCGTAATGCTA -> CTAAATCCCGTAATGCTAA
ACTAACTAGGCGGCGCAGA -> CTAACTAGGCGGCGCAGAA
ACTAGACGGCGTCATAAGA -> CTAGACGGCGTCATAAGAG
ACTAGGCGGCGCAGAAAGT -> CTAGGCGGCGCAGAAAGTG
ACTATGTAGTATCACAAGT -> CTATGTAGTATCACAAGTA
ACTATTCATCCAGGTCCTG -> CTATTCATCCAGGTCCTGC
ACTCTTAGAGACTATGTAG -> CTCTTAGAGACTATGTAGT
ACTGAAGCAATGCTTGGCG -> CTGAAGCAATGCTTGGCGC
ACTGAGATACAGATACCTG -> CTGAGATACAGATACCTGG
ACTGCCATAGCCTGCTCCC -> CTGCCATAGCCTGCTCCCA
ACTGCGGCGTCGACCTCTT -> CTGCGGCGTCGACCTCTTG
ACTGCGGTCGCTCTGAGCA -> CTGCGGTCGCTCTGAGCAA
ACTGGGAATAGAAAAATCT -> CTGGGAATAGAAAAATCTT
ACTGGGGCTCCTCCTTGAT -> CTGGGGCTCCTCCTTGATG
ACTGGGGGAACCAACCGGA -> CTGGGGGAACCAACCGGAC
ACTGGTTTAGGCGATTTGT -> CTGGTTTAGGCGATTTGTT
ACTGTCGCAAATTTAGCGA -> CTGTCGCAAATTTAGCGAG
ACTGTGCTGGTACTAGACG -> CTGTGCTGGTACTAGACGG
ACTGTGTATCACATGTGGG -> CTGTGTATCACATGTGGGG
ACTTACACCGCGTTAATAC -> CTTACACCGCGTTAATACG
ACTTATAACGGAACTGGGG -> CTTATAACGGAACTGGGGG
ACTTATAGTACTGCGGTCG -> CTTATAGTACTGCGGTCGC
ACTTGGAGGTGAGAGAAAT -> CTTGGAGGTGAGAGAAATA
ACTTGTTGACGACTTTCGA -> CTTGTTGACGACTTTCGAA
ACTTTATATTTTGCTCATA -> CTTTATATTTTGCTCATAA
ACTTTCCGAGTTATTACGC -> CTTTCCGAGTTATTACGCA
ACTTTCGAATAGTCCCGAA -> CTTTCGAATAGTCCCGAAA
ACTTTGTCTCAACGGCACT -> CTTTGTCTCAACGGCACTA
AGAAAAATCTTCACACGAT -> GAAAAATCTTCACACGATC
AGAAAAGCTTGCAACTGTC -> GAAAAGCTTGCAACTGTCG
AGAAAGTGCGACATAAGGC -> GAAAGTGCGACATAAGGCG
AGAAATAATCCACAAAGTC -> GAAATAATCCACAAAGTCG
AGAACAAAGCTCCTATCCG -> GAACAAAGCTCCTATCCGT
AGAAGATATTATAGGTATT -> GAAGATATTATAGGTATTC
AGAAGCGGTGTCGGCACCA -> GAAGCGGTGTCGGCACCAG
AGAATAACACGAGACCAAT -> GAATAACACGAGACCAATC
AGACAAGAAAAGCTTGCAA -> GACAAGAAAAGCTTGCAAC
AGACCAATCGTTGGATGTA -> GACCAATCGTTGGATGTAG
AGACCCCGGGTGCAATACC -> GACCCCGGGTGCAATACCC
AGACCTCAAAGTCTTCCAT -> GACCTCAAAGTCTTCCATA
AGACGCGGTTGTTCCAATT -> GACGCGGTTGTTCCAATTG
AGACGGCGTCATAAGAGGG -> GACGGCGTCATAAGAGGGA
AGACGGCTGCATGGGTTAT -> GACGGCTGCATGGGTTATG
AGACGTAGCGGTTTGGTAA -> GACGTAGCGGTTTGGTAAA
AGACTATGTAGTATCACAA -> GACTATGTAGTATCACAAG
AGACTTTATATTTTGCTCA -> GACTTTATATTTTGCTCAT
AGAGAAATAATCCACAAAG -> GAGAAATAATCCACAAAGT
AGAGAACAAAGCTCCTATC -> GAGAACAAAGCTCCTATCC
AGAGAAGCGGTGTCGGCAC -> GAGAAGCGGTGTCGGCACC
AGAGACTATGTAGTATCAC -> GAGACTATGTAGTATCACA
AGAGATGCTTAGCCGAATG -> GAGATGCTTAGCCGAATGT
AGAGCCCACCAAGCCCCGT -> GAGCCCACCAAGCCCCGTT
AGAGGGAGCTATCCAGATG -> GAGGGAGCTATCCAGATGG
AGAGGGCGCCAGTTAGCCC -> GAGGGCGCCAGTTAGCCCG
AGAGGTACTGGTTTAGGCG -> GAGGTACTGGTTTAGGCGA
AGAGTCATAGACCTCAAAG -> GAGTCATAGACCTCAAAGT
AGAGTGCTGGTTAACTTGT -> GAGTGCTGGTTAACTTGTT
AGATACAGATACCTGGATA -> GATACAGATACCTGGATAC
AGATACCTGGATACTGTGC -> GATACCTGGATACTGTGCT
AGATAGTATTTGCCCGGAA -> GATAGTATTTGCCCGGAAG
AGATAGTGCCAGCGGACGC -> GATAGTGCCAGCGGACGCC
AGATATTATAGGTATTCTT -> GATATTATAGGTATTCTTT
AGATCATCGGATCGATCCT -> GATCATCGGATCGATCCTG
AGATGAAGATAGTATTTGC -> GATGAAGATAGTATTTGCC
AGATGCTTAGCCGAATGTA -> GATGCTTAGCCGAATGTAA
AGATGGGAAAACTATTCAT -> GATGGGAAAACTATTCATC
AGATGGGCCGGAATGCGAG -> GATGGGCCGGAATGCGAGA
AGATTCCAGGATGAATACG -> GATTCCAGGATGAATACGG
AGCAAAGGGACCGGGATAG -> GCAAAGGGACCGGGATAGG
AGCAATGCTTGGCGCAGGT -> GCAATGCTTGGCGCAGGTA
AGCACTGAAGCAATGCTTG -> GCACTGAAGCAATGCTTGG
AGCACTGTGTATCACATGT -> GCACTGTGTATCACATGTG
AGCAGGAGTGGAGGTTACA -> GCAGGAGTGGAGGTTACAT
AGCCATTTGGGTACCTCGA -> GCCATTTGGGTACCTCGAT
AGCCCACCAAGCCCCGTTC -> GCCCACCAAGCCCCGTTCG
AGCCCAGCCATTTGGGTAC -> GCCCAGCCATTTGGGTACC
AGCCCAGTACAACCTAACA -> GCCCAGTACAACCTAACAG
AGCCCCGTTCGTTGAGTAA -> GCCCCGTTCGTTGAGTAAC
AGCCCGAGTAATAGTACAG -> GCCCGAGTAATAGTACAGG
AGCCCTTCTGTTGTGTGGT -> GCCCTTCTGTTGTGTGGTA
AGCCGAATGTAATGTTCAG -> GCCGAATGTAATGTTCAGT
AGCCTGCTCCCATGATCCT -> GCCTGCTCCCATGATCCTC
AGCGAATTACTTACACCGC -> GCGAATTACTTACACCGCG
AGCGAGAGAAGCGGTGTCG -> GCGAGAGAAGCGGTGTCGG
AGCGAGGGTATTCCATGGC -> GCGAGGGTATTCCATGGCT
AGCGCAGAATAACACGAGA -> GCGCAGAATAACACGAGAC
AGCGCGGATCCAGGAGTGT -> GCGCGGATCCAGGAGTGTG
AGCGCGTTAAGTAGCTCTT -> GCGCGTTAAGTAGCTCTTT
AGCGGACGCCATCAGAAGA -> GCGGACGCCATCAGAAGAT
AGCGGCAGACGCGGTTGTT -> GCGGCAGACGCGGTTGTTC
AGCGGTGTCGGCACCAGAC -> GCGGTGTCGGCACCAGACG
AGCGGTTTGGTAAAATGTC -> GCGGTTTGGTAAAATGTCT
AGCTATCCAGATGGGAAAA -> GCTATCCAGATGGGAAAAC
AGCTCAGATTCCAGGATGA -> GCTCAGATTCCAGGATGAA
AGCTCCAAGCAGGAGTGGA -> GCTCCAAGCAGGAGTGGAG
AGCTCCCGGGGTGCCTGGA -> GCTCCCGGGGTGCCTGGAT
AGCTCCCGGGGTGCCTGGC -> GCTCCCGGGGTGCCTGGCC
AGCTCCCGGGGTGCCTGGG -> GCTCCCGGGGTGCCTGGGG
AGCTCCCGGGGTGCCTGGT -> GCTCCCGGGGTGCCTGGTA
AGCTCCTATCCGTTATGGA -> GCTCCTATCCGTTATGGAT
AGCTCGTGTCAAGTCAGCG -> GCTCGTGTCAAGTCAGCGG
AGCTCTTTGCACAAAATCA -> GCTCTTTGCACAAAATCAA
AGCTGTATTTATATAACAC -> GCTGTATTTATATAACACT
AGCTTCTACCCGCTAAGCA -> GCTTCTACCCGCTAAGCAC
AGCTTGCAACTGTCGCAAA -> GCTTGCAACTGTCGCAAAT
AGGAACGCGCGCGCTAATA -> GGAACGCGCGCGCTAATAG
AGGAAGTTAGTGAGAGTGC -> GGAAGTTAGTGAGAGTGCT
AGGAATGAACAAATCTCAT -> GGAATGAACAAATCTCATT
AGGAATGAACAATCGGTTG -> GGAATGAACAATCGGTTGA
AGGAATGAACATGGGGAAG -> GGAATGAACATGGGGAAGT
AGGAATGAACATTACTCTT -> GGAATGAACATTACTCTTA
AGGACATCCGTGCACCACC -> GGACATCCGTGCACCACCA
AGGAGTGGAGGTTACATTC -> GGAGTGGAGGTTACATTCC
AGGAGTGTGATATCACCTT -> GGAGTGTGATATCACCTTA
AGGATGAATACGGTAAGAT -> GGATGAATACGGTAAGATG
AGGCATTTATCCCGTAAGG -> GGCATTTATCCCGTAAGGT
AGGCCACTGCCATAGCCTG -> GGCCACTGCCATAGCCTGC
AGGCCATATAACCGTTAAA -> GGCCATATAACCGTTAAAT
AGGCCGTGAGTGGGCCTAG -> GGCCGTGAGTGGGCCTAGC
AGGCGAAGGTAATGCAGGA -> GGCGAAGGTAATGCAGGAA
AGGCGATTTGTTACTTTCC -> GGCGATTTGTTACTTTCCG
AGGCGGACATAAGTCGCGC -> GGCGGACATAAGTCGCGCT
AGGCGGCGCAGAAAGTGCG -> GGCGGCGCAGAAAGTGCGA
AGGCGGTCATCCTAAACAG -> GGCGGTCATCCTAAACAGT
AGGCGGTCTCGGTCTCAAG -> GGCGGTCTCGGTCTCAAGG
AGGCGTGGTAATGCAGGAA -> GGCGTGGTAATGCAGGAAT
AGGCTCACCTAACAATACC -> GGCTCACCTAACAATACCG
AGGGACCGGGATAGGACAT -> GGGACCGGGATAGGACATC
AGGGAGCTATCCAGATGGG -> GGGAGCTATCCAGATGGGA
AGGGATTATACCACTTATA -> GGGATTATACCACTTATAG
AGGGCGACGTCACGTAGTG -> GGGCGACGTCACGTAGTGG
AGGGCGCCAGTTAGCCCGA -> GGGCGCCAGTTAGCCCGAG
AGGGGAAGATGAAGATAGT -> GGGGAAGATGAAGATAGTA
AGGGTATTCCATGGCTGCG -> GGGTATTCCATGGCTGCGG
AGGGTCATTGCGGACCTGT -> GGGTCATTGCGGACCTGTC
AGGTAATGCAGGAATGAAC -> GGTAATGCAGGAATGAACA
AGGTACTGGTTTAGGCGAT -> GGTACTGGTTTAGGCGATT
AGGTATCAGACAAGAAAAG -> GGTATCAGACAAGAAAAGC
AGGTATCTTCATAAGGTCC -> GGTATCTTCATAAGGTCCG
AGGTATTCTTTGGCGGGAT -> GGTATTCTTTGGCGGGATG
AGGTCCGCCCGATGCCCTG -> GGTCCGCCCGATGCCCTGT
AGGTCCTGCAGCGCAGAAT -> GGTCCTGCAGCGCAGAATA
AGGTCCTTCGATAGGCCGT -> GGTCCTTCGATAGGCCGTG
AGGTCTTCTACAAAGGAAC -> GGTCTTCTACAAAGGAACG
AGGTGAGAGAAATAATCCA -> GGTGAGAGAAATAATCCAC
AGGTGGTCGTAGGCCACTG -> GGTGGTCGTAGGCCACTGC
AGGTTACATTCCTTGGTTC -> GGTTACATTCCTTGGTTCG
AGGTTTAGGAAGTTAGTGA -> GGTTTAGGAAGTTAGTGAG
AGTAACCGGTAATTATAGG -> GTAACCGGTAATTATAGGG
AGTAACTGAGATACAGATA -> GTAACTGAGATACAGATAC
AGTAATAGTACAGGTCTTC -> GTAATAGTACAGGTCTTCT
AGTACAACCTAACAGAGAA -> GTACAACCTAACAGAGAAC
AGTACAGGTCTTCTACAAA -> GTACAGGTCTTCTACAAAG
AGTACTGCGGTCGCTCTGA -> GTACTGCGGTCGCTCTGAG
AGTAGATCATCGGATCGAT -> GTAGATCATCGGATCGATC
AGTAGCTCTTTGCACAAAA -> GTAGCTCTTTGCACAAAAT
AGTATAAGTTTATGCTTGT -> GTATAAGTTTATGCTTGTG
AGTATCACAAGTAGATCAT -> GTATCACAAGTAGATCATC
AGTATTTGCCCGGAAGCTC -> GTATTTGCCCGGAAGCTCC
AGTCACAGAGCCCACCAAG -> GTCACAGAGCCCACCAAGC
AGTCAGCGGCAGACGCGGT -> GTCAGCGGCAGACGCGGTT
AGTCATAGACCTCAAAGTC -> GTCATAGACCTCAAAGTCT
AGTCCCGAAATACGACCAT -> GTCCCGAAATACGACCATT
AGTCGCGCTCAAAGCGCGT -> GTCGCGCTCAAAGCGCGTT
AGTCGGGTGTTCGCCCGCA -> GTCGGGTGTTCGCCCGCAG
AGTCTTCCATATTGTCCTT -> GTCTTCCATATTGTCCTTC
AGTGAGACCCCGGGTGCAA -> GTGAGACCCCGGGTGCAAT
AGTGAGAGTGCTGGTTAAC -> GTGAGAGTGCTGGTTAACT
AGTGCCAGCGGACGCCATC -> GTGCCAGCGGACGCCATCA
AGTGCGACATAAGGCGGTC -> GTGCGACATAAGGCGGTCA
AGTGCTGGTTAACTTGTTG -> GTGCTGGTTAACTTGTTGA
AGTGGAAGGCGGACATAAG -> GTGGAAGGCGGACATAAGT
AGTGGAGGTTACATTCCTT -> GTGGAGGTTACATTCCTTG
AGTGGGCCTAGCTCAGATT -> GTGGGCCTAGCTCAGATTC
AGTGGTAATGCAGGAATGA -> GTGGTAATGCAGGAATGAA
AGTGGTATGTCAGCTGTAT -> GTGGTATGTCAGCTGTATT
AGTGTGATATCACCTTAAC -> GTGTGATATCACCTTAACA
AGTTAGCCCGAGTAATAGT -> GTTAGCCCGAGTAATAGTA
AGTTAGTGAGAGTGCTGGT -> GTTAGTGAGAGTGCTGGTT
AGTTATTACGCATGGGTGG -> GTTATTACGCATGGGTGGA
AGTTGCCCTTGTTAATCGT -> GTTGCCCTTGTTAATCGTC
AGTTTATGCTTGTGTTTGG -> GTTTATGCTTGTGTTTGGG
ATAACACGAGACCAATCGT -> TAACACGAGACCAATCGTT
ATAACACTTGGAGGTGAGA -> TAACACTTGGAGGTGAGAG
ATAACCGTTAAATGTGGCT -> TAACCGTTAAATGTGGCTG
ATAACGGAACTGGGGGAAC -> TAACGGAACTGGGGGAACC
ATAAGAGGGAGCTATCCAG -> TAAGAGGGAGCTATCCAGA
ATAAGGCGGTCATCCTAAA -> TAAGGCGGTCATCCTAAAC
ATAAGGTCCGCCCGATGCC -> TAAGGTCCGCCCGATGCCC
ATAAGTCGCGCTCAAAGCG -> TAAGTCGCGCTCAAAGCGC
ATAAGTTTATGCTTGTGTT -> TAAGTTTATGCTTGTGTTT
ATAATATCCGGGGCGTACT -> TAATATCCGGGGCGTACTG
ATAATCCACAAAGTCGGGT -> TAATCCACAAAGTCGGGTG
ATACAGATACCTGGATACT -> TACAGATACCTGGATACTG
ATACCACTTATAGTACTGC -> TACCACTTATAGTACTGCG
ATACCCAGGCTCACCTAAC -> TACCCAGGCTCACCTAACA
ATACCGTTCGTTGTGAGAG -> TACCGTTCGTTGTGAGAGT
ATACCTGGATACTGTGCTG -> TACCTGGATACTGTGCTGG
ATACGACCATTTCCACCTA -> TACGACCATTTCCACCTAA
ATACGAGGGGAAGATGAAG -> TACGAGGGGAAGATGAAGA
ATACGGTAAGATGGGCCGG -> TACGGTAAGATGGGCCGGA
ATACTGTGCTGGTACTAGA -> TACTGTGCTGGTACTAGAC
ATAGAAAAATCTTCACACG -> TAGAAAAATCTTCACACGA
ATAGACCTCAAAGTCTTCC -> TAGACCTCAAAGTCTTCCA
ATAGAGATGCTTAGCCGAA -> TAGAGATGCTTAGCCGAAT
ATAGAGGTACTGGTTTAGG -> TAGAGGTACTGGTTTAGGC
ATAGCCCAGTACAACCTAA -> TAGCCCAGTACAACCTAAC
ATAGCCTGCTCCCATGATC -> TAGCCTGCTCCCATGATCC
ATAGCTCCCGGGGTGCCTG -> TAGCTCCCGGGGTGCCTGG
ATAGGACATCCGTGCACCA -> TAGGACATCCGTGCACCAC
ATAGGCCGTGAGTGGGCCT -> TAGGCCGTGAGTGGGCCTA
ATAGGGTCATTGCGGACCT -> TAGGGTCATTGCGGACCTG
ATAGGTATCTTCATAAGGT -> TAGGTATCTTCATAAGGTC
ATAGGTATTCTTTGGCGGG -> TAGGTATTCTTTGGCGGGA
ATAGTACAGGTCTTCTACA -> TAGTACAGGTCTTCTACAA
ATAGTACTGCGGTCGCTCT -> TAGTACTGCGGTCGCTCTG
ATAGTATTTGCCCGGAAGC -> TAGTATTTGCCCGGAAGCT
ATAGTCCCGAAATACGACC -> TAGTCCCGAAATACGACCA
ATAGTGCCAGCGGACGCCA -> TAGTGCCAGCGGACGCCAT
ATAGTGGTAATGCAGGAAT -> TAGTGGTAATGCAGGAATG
ATATAACACTTGGAGGTGA -> TATAACACTTGGAGGTGAG
ATATAACCGTTAAATGTGG -> TATAACCGTTAAATGTGGC
ATATCACCTTAACATGCAG -> TATCACCTTAACATGCAGG
ATATCCGGGGCGTACTGCG -> TATCCGGGGCGTACTGCGG
ATATCTCATGTAACAGTGG -> TATCTCATGTAACAGTGGT
ATATGAGGTCCTTCGATAG -> TATGAGGTCCTTCGATAGG
ATATTATAGGTATTCTTTG -> TATTATAGGTATTCTTTGG
ATATTGTCCTTCTGGCGTG -> TATTGTCCTTCTGGCGTGA
ATATTTTGCTCATAATCCA -> TATTTTGCTCATAATCCAG
ATCAACTTATAACGGAACT -> TCAACTTATAACGGAACTG
ATCAATTCTGTTCAGAGGG -> TCAATTCTGTTCAGAGGGC
ATCACAAGTAGATCATCGG -> TCACAAGTAGATCATCGGA
ATCACATGTGGGGAATAGC -> TCACATGTGGGGAATAGCC
ATCACCTTAACATGCAGGC -> TCACCTTAACATGCAGGCC
ATCACTAACTAGGCGGCGC -> TCACTAACTAGGCGGCGCA
ATCAGAAGATATTATAGGT -> TCAGAAGATATTATAGGTA
ATCAGACAAGAAAAGCTTG -> TCAGACAAGAAAAGCTTGC
ATCAGCCCTTCTGTTGTGT -> TCAGCCCTTCTGTTGTGTG
ATCATCGGATCGATCCTGA -> TCATCGGATCGATCCTGAG
ATCCACAAAGTCGGGTGTT -> TCCACAAAGTCGGGTGTTC
ATCCAGATGGGAAAACTAT -> TCCAGATGGGAAAACTATT
ATCCAGGAGTGTGATATCA -> TCCAGGAGTGTGATATCAC
ATCCAGGTCCTGCAGCGCA -> TCCAGGTCCTGCAGCGCAG
ATCCCGTAAGGTGGTCGTA -> TCCCGTAAGGTGGTCGTAG
ATCCCGTAATGCTAAATTC -> TCCCGTAATGCTAAATTCT
ATCCGGGGCGTACTGCGGC -> TCCGGGGCGTACTGCGGCG
ATCCGTGCACCACCAGTGA -> TCCGTGCACCACCAGTGAG
ATCCGTTATGGATATCTCA -> TCCGTTATGGATATCTCAT
ATCCTAAACAGTTGCCCTT -> TCCTAAACAGTTGCCCTTG
ATCCTCCAAACGGAGCACT -> TCCTCCAAACGGAGCACTG
ATCCTGAGGGCGACGTCAC -> TCCTGAGGGCGACGTCACG
ATCGATCCTGAGGGCGACG -> TCGATCCTGAGGGCGACGT
ATCGCAATAGGTATCTTCA -> TCGCAATAGGTATCTTCAT
ATCGGATCGATCCTGAGGG -> TCGGATCGATCCTGAGGGC
ATCGGTTGACCTCTAAACG -> TCGGTTGACCTCTAAACGA
ATCGTCTCCAGACGTAGCG -> TCGTCTCCAGACGTAGCGG
ATCGTTGGATGTAGCTCGT -> TCGTTGGATGTAGCTCGTG
ATCTCATGTAACAGTGGTA -> TCTCATGTAACAGTGGTAT
ATCTCATTTTTAAACATTG -> TCTCATTTTTAAACATTGT
ATCTTCACACGATCACTAA -> TCTTCACACGATCACTAAC
ATCTTCATAAGGTCCGCCC -> TCTTCATAAGGTCCGCCCG
ATGAACAAATCTCATTTTT -> TGAACAAATCTCATTTTTA
ATGAACAATCGGTTGACCT -> TGAACAATCGGTTGACCTC
ATGAACATGGGGAAGTAAC -> TGAACATGGGGAAGTAACT
ATGAACATTACTCTTAGAG -> TGAACATTACTCTTAGAGA
ATGAAGATAGTATTTGCCC -> TGAAGATAGTATTTGCCCG
ATGAAGGCGAAGGTAATGC -> TGAAGGCGAAGGTAATGCA
ATGAATACGGTAAGATGGG -> TGAATACGGTAAGATGGGC
ATGACAAAGCCCAGCCATT -> TGACAAAGCCCAGCCATTT
ATGACGTCGCAGCGAATTA -> TGACGTCGCAGCGAATTAC
ATGAGATAGTGCCAGCGGA -> TGAGATAGTGCCAGCGGAC
ATGAGGTCCTTCGATAGGC -> TGAGGTCCTTCGATAGGCC
ATGATAATATCCGGGGCGT -> TGATAATATCCGGGGCGTA
ATGATAGAGATGCTTAGCC -> TGATAGAGATGCTTAGCCG
ATGATCCTCCAAACGGAGC -> TGATCCTCCAAACGGAGCA
ATGCAGGAATGAACAAATC -> TGCAGGAATGAACAAATCT
ATGCAGGAATGAACAATCG -> TGCAGGAATGAACAATCGG
ATGCAGGAATGAACATGGG -> TGCAGGAATGAACATGGGG
ATGCAGGAATGAACATTAC -> TGCAGGAATGAACATTACT
ATGCAGGCCATATAACCGT -> TGCAGGCCATATAACCGTT
ATGCCCTGTAATTAAGTCA -> TGCCCTGTAATTAAGTCAC
ATGCGAGACTTTATATTTT -> TGCGAGACTTTATATTTTG
ATGCGAGGTTTAGGAAGTT -> TGCGAGGTTTAGGAAGTTA
ATGCTAAATTCTTAACAGC -> TGCTAAATTCTTAACAGCG
ATGCTTAGCCGAATGTAAT -> TGCTTAGCCGAATGTAATG
ATGCTTGGCGCAGGTATCA -> TGCTTGGCGCAGGTATCAG
ATGCTTGTGTTTGGGGTCC -> TGCTTGTGTTTGGGGTCCG
ATGCTTTCATGGAATGATA -> TGCTTTCATGGAATGATAA
ATGGAATGATAATATCCGG -> TGGAATGATAATATCCGGG
ATGGATATCTCATGTAACA -> TGGATATCTCATGTAACAG
ATGGCTGCGGCCCCGATGC -> TGGCTGCGGCCCCGATGCT
ATGGGAAAACTATTCATCC -> TGGGAAAACTATTCATCCA
ATGGGCCGGAATGCGAGAC -> TGGGCCGGAATGCGAGACT
ATGGGGAAGTAACTGAGAT -> TGGGGAAGTAACTGAGATA
ATGGGTGGAATTCGACTGG -> TGGGTGGAATTCGACTGGG
ATGGGTTATGATAGAGATG -> TGGGTTATGATAGAGATGC
ATGTAACAGTGGTATGTCA -> TGTAACAGTGGTATGTCAG
ATGTAATGTTCAGTATAAG -> TGTAATGTTCAGTATAAGT
ATGTAGCTCGTGTCAAGTC -> TGTAGCTCGTGTCAAGTCA
ATGTAGTATCACAAGTAGA -> TGTAGTATCACAAGTAGAT
ATGTCAGCTGTATTTATAT -> TGTCAGCTGTATTTATATA
ATGTCTCAGCGAGGGTATT -> TGTCTCAGCGAGGGTATTC
ATGTGGCTGGCATCAGCCC -> TGTGGCTGGCATCAGCCCT
ATGTGGGGAATAGCCCAGT -> TGTGGGGAATAGCCCAGTA
ATGTTCAGTATAAGTTTAT -> TGTTCAGTATAAGTTTATG
ATTAAGTCACAGAGCCCAC -> TTAAGTCACAGAGCCCACC
ATTACGCATGGGTGGAATT -> TTACGCATGGGTGGAATTC
ATTACTCTTAGAGACTATG -> TTACTCTTAGAGACTATGT
ATTACTTACACCGCGTTAA -> TTACTTACACCGCGTTAAT
ATTATACCACTTATAGTAC -> TTATACCACTTATAGTACT
ATTATAGGGTCATTGCGGA -> TTATAGGGTCATTGCGGAC
ATTATAGGTATTCTTTGGC -> TTATAGGTATTCTTTGGCG
ATTATTCCAGGCGGTCTCG -> TTATTCCAGGCGGTCTCGG
ATTCATCCAGGTCCTGCAG -> TTCATCCAGGTCCTGCAGC
ATTCCAGGATGAATACGGT -> TTCCAGGATGAATACGGTA
ATTCCAGGCGGTCTCGGTC -> TTCCAGGCGGTCTCGGTCT
ATTCCATGGCTGCGGCCCC -> TTCCATGGCTGCGGCCCCG
ATTCCTTGGTTCGTTTAAT -> TTCCTTGGTTCGTTTAATA
ATTCGACTGGGAATAGAAA -> TTCGACTGGGAATAGAAAA
ATTCTGTTCAGAGGGCGCC -> TTCTGTTCAGAGGGCGCCA
ATTCTTAACAGCGCGGATC -> TTCTTAACAGCGCGGATCC
ATTCTTTGGCGGGATGACG -> TTCTTTGGCGGGATGACGT
ATTGAGCTTCTACCCGCTA -> TTGAGCTTCTACCCGCTAA
ATTGCGGACCTGTCGAGCT -> TTGCGGACCTGTCGAGCTC
ATTGTCCTTCTGGCGTGAC -> TTGTCCTTCTGGCGTGACT
ATTGTGAACCTACGCGATC -> TTGTGAACCTACGCGATCA
ATTTAGCGAGAGAAGCGGT -> TTTAGCGAGAGAAGCGGTG
ATTTATATAACACTTGGAG -> TTTATATAACACTTGGAGG
ATTTATCCCGTAAGGTGGT -> TTTATCCCGTAAGGTGGTC
ATTTCCACCTAATCGCAAT -> TTTCCACCTAATCGCAATA
ATTTGCCCGGAAGCTCCCG -> TTTGCCCGGAAGCTCCCGG
ATTTGGGTACCTCGATATG -> TTTGGGTACCTCGATATGA
ATTTGTTACTTTCCGAGTT -> TTTGTTACTTTCCGAGTTA
ATTTTGCTCATAATCCAGC -> TTTTGCTCATAATCCAGCG
ATTTTTAAACATTGTGAAC -> TTTTTAAACATTGTGAACC
CAAAATCAATTCTGTTCAG -> AAAATCAATTCTGTTCAGA
CAAACGGAGCACTGAAGCA -> AAACGGAGCACTGAAGCAA
CAAAGCCCAGCCATTTGGG -> AAAGCCCAGCCATTTGGGT
CAAAGCGCGTTAAGTAGCT -> AAAGCGCGTTAAGTAGCTC
CAAAGCTCCAAGCAGGAGT -> AAAGCTCCAAGCAGGAGTG
CAAAGCTCCTATCCGTTAT -> AAAGCTCCTATCCGTTATG
CAAAGGAACGCGCGCGCTA -> AAAGGAACGCGCGCGCTAA
CAAAGGGACCGGGATAGGA -> AAAGGGACCGGGATAGGAC
CAAAGTCGGGTGTTCGCCC -> AAAGTCGGGTGTTCGCCCG
CAAAGTCTTCCATATTGTC -> AAAGTCTTCCATATTGTCC
CAAATCTCATTTTTAAACA -> AAATCTCATTTTTAAACAT
CAAATTTAGCGAGAGAAGC -> AAATTTAGCGAGAGAAGCG
CAACCGGACTGGGGCTCCT -> AACCGGACTGGGGCTCCTC
CAACCTAACAGAGAACAAA -> AACCTAACAGAGAACAAAG
CAACGGCACTAAATCCCGT -> AACGGCACTAAATCCCGTA
CAACTGTCGCAAATTTAGC -> AACTGTCGCAAATTTAGCG
CAACTTATAACGGAACTGG -> AACTTATAACGGAACTGGG
CAAGAAAAGCTTGCAACTG -> AAGAAAAGCTTGCAACTGT
CAAGCAGGAGTGGAGGTTA -> AAGCAGGAGTGGAGGTTAC
CAAGCCCCGTTCGTTGAGT -> AAGCCCCGTTCGTTGAGTA
CAAGGGATTATACCACTTA -> AAGGGATTATACCACTTAT
CAAGTAGATCATCGGATCG -> AAGTAGATCATCGGATCGA
CAAGTCAGCGGCAGACGCG -> AAGTCAGCGGCAGACGCGG
CAATACCCAGGCTCACCTA -> AATACCCAGGCTCACCTAA
CAATACCGTTCGTTGTGAG -> AATACCGTTCGTTGTGAGA
CAATAGGTATCTTCATAAG -> AATAGGTATCTTCATAAGG
CAATCGGTTGACCTCTAAA -> AATCGGTTGACCTCTAAAC
CAATCGTTGGATGTAGCTC -> AATCGTTGGATGTAGCTCG
CAATGCTTGGCGCAGGTAT -> AATGCTTGGCGCAGGTATC
CAATTCTGTTCAGAGGGCG -> AATTCTGTTCAGAGGGCGC
CAATTGAGCTTCTACCCGC -> AATTGAGCTTCTACCCGCT
CACAAAATCAATTCTGTTC -> ACAAAATCAATTCTGTTCA
CACAAAGTCGGGTGTTCGC -> ACAAAGTCGGGTGTTCGCC
CACAAGTAGATCATCGGAT -> ACAAGTAGATCATCGGATC
CACACGATCACTAACTAGG -> ACACGATCACTAACTAGGC
CACAGAGCCCACCAAGCCC -> ACAGAGCCCACCAAGCCCC
CACATGTGGGGAATAGCCC -> ACATGTGGGGAATAGCCCA
CACCAAGCCCCGTTCGTTG -> ACCAAGCCCCGTTCGTTGA
CACCACCAGTGAGACCCCG -> ACCACCAGTGAGACCCCGG
CACCAGACGGCTGCATGGG -> ACCAGACGGCTGCATGGGT
CACCAGTGAGACCCCGGGT -> ACCAGTGAGACCCCGGGTG
CACCATGAGATAGTGCCAG -> ACCATGAGATAGTGCCAGC
CACCGCGTTAATACGAGGG -> ACCGCGTTAATACGAGGGG
CACCTAACAATACCGTTCG -> ACCTAACAATACCGTTCGT
CACCTAATCGCAATAGGTA -> ACCTAATCGCAATAGGTAT
CACCTTAACATGCAGGCCA -> ACCTTAACATGCAGGCCAT
CACGAGACCAATCGTTGGA -> ACGAGACCAATCGTTGGAT
CACGATCACTAACTAGGCG -> ACGATCACTAACTAGGCGG
CACGTAGTGGAAGGCGGAC -> ACGTAGTGGAAGGCGGACA
CACTAAATCCCGTAATGCT -> ACTAAATCCCGTAATGCTA
CACTAACTAGGCGGCGCAG -> ACTAACTAGGCGGCGCAGA
CACTGAAGCAATGCTTGGC -> ACTGAAGCAATGCTTGGCG
CACTGCCATAGCCTGCTCC -> ACTGCCATAGCCTGCTCCC
CACTGTGTATCACATGTGG -> ACTGTGTATCACATGTGGG
CACTTATAGTACTGCGGTC -> ACTTATAGTACTGCGGTCG
CACTTGGAGGTGAGAGAAA -> ACTTGGAGGTGAGAGAAAT
CAGAAAGTGCGACATAAGG -> AGAAAGTGCGACATAAGGC
CAGAAGATATTATAGGTAT -> AGAAGATATTATAGGTATT
CAGAATAACACGAGACCAA -> AGAATAACACGAGACCAAT
CAGACAAGAAAAGCTTGCA -> AGACAAGAAAAGCTTGCAA
CAGACGCGGTTGTTCCAAT -> AGACGCGGTTGTTCCAATT
CAGACGGCTGCATGGGTTA -> AGACGGCTGCATGGGTTAT
CAGACGTAGCGGTTTGGTA -> AGACGTAGCGGTTTGGTAA
CAGAGAACAAAGCTCCTAT -> AGAGAACAAAGCTCCTATC
CAGAGCCCACCAAGCCCCG -> AGAGCCCACCAAGCCCCGT
CAGAGGGCGCCAGTTAGCC -> AGAGGGCGCCAGTTAGCCC
CAGATACCTGGATACTGTG -> AGATACCTGGATACTGTGC
CAGATGGGAAAACTATTCA -> AGATGGGAAAACTATTCAT
CAGATTCCAGGATGAATAC -> AGATTCCAGGATGAATACG
CAGCCATTTGGGTACCTCG -> AGCCATTTGGGTACCTCGA
CAGCCCTTCTGTTGTGTGG -> AGCCCTTCTGTTGTGTGGT
CAGCGAATTACTTACACCG -> AGCGAATTACTTACACCGC
CAGCGAGGGTATTCCATGG -> AGCGAGGGTATTCCATGGC
CAGCGCAGAATAACACGAG -> AGCGCAGAATAACACGAGA
CAGCGCGGATCCAGGAGTG -> AGCGCGGATCCAGGAGTGT
CAGCGGACGCCATCAGAAG -> AGCGGACGCCATCAGAAGA
CAGCGGCAGACGCGGTTGT -> AGCGGCAGACGCGGTTGTT
CAGCTCCCGGGGTGCCTGG -> AGCTCCCGGGGTGCCTGGC
CAGCTGTATTTATATAACA -> AGCTGTATTTATATAACAC
CAGGAATGAACAAATCTCA -> AGGAATGAACAAATCTCAT
CAGGAATGAACAATCGGTT -> AGGAATGAACAATCGGTTG
CAGGAATGAACATGGGGAA -> AGGAATGAACATGGGGAAG
CAGGAATGAACATTACTCT -> AGGAATGAACATTACTCTT
CAGGAGTGGAGGTTACATT -> AGGAGTGGAGGTTACATTC
CAGGAGTGTGATATCACCT -> AGGAGTGTGATATCACCTT
CAGGATGAATACGGTAAGA -> AGGATGAATACGGTAAGAT
CAGGCCATATAACCGTTAA -> AGGCCATATAACCGTTAAA
CAGGCGGTCTCGGTCTCAA -> AGGCGGTCTCGGTCTCAAG
CAGGCGTGGTAATGCAGGA -> AGGCGTGGTAATGCAGGAA
CAGGCTCACCTAACAATAC -> AGGCTCACCTAACAATACC
CAGGTATCAGACAAGAAAA -> AGGTATCAGACAAGAAAAG
CAGGTCCTGCAGCGCAGAA -> AGGTCCTGCAGCGCAGAAT
CAGGTCTTCTACAAAGGAA -> AGGTCTTCTACAAAGGAAC
CAGTACAACCTAACAGAGA -> AGTACAACCTAACAGAGAA
CAGTATAAGTTTATGCTTG -> AGTATAAGTTTATGCTTGT
CAGTGAGACCCCGGGTGCA -> AGTGAGACCCCGGGTGCAA
CAGTGGTATGTCAGCTGTA -> AGTGGTATGTCAGCTGTAT
CAGTTAGCCCGAGTAATAG -> AGTTAGCCCGAGTAATAGT
CAGTTGCCCTTGTTAATCG -> AGTTGCCCTTGTTAATCGT
CATAAGAGGGAGCTATCCA -> ATAAGAGGGAGCTATCCAG
CATAAGGCGGTCATCCTAA -> ATAAGGCGGTCATCCTAAA
CATAAGGTCCGCCCGATGC -> ATAAGGTCCGCCCGATGCC
CATAAGTCGCGCTCAAAGC -> ATAAGTCGCGCTCAAAGCG
CATAATCCAGCGCCGCATA -> ATAATCCAGCGCCGCATAA
CATAGACCTCAAAGTCTTC -> ATAGACCTCAAAGTCTTCC
CATAGCCTGCTCCCATGAT -> ATAGCCTGCTCCCATGATC
CATAGTGGTAATGCAGGAA -> ATAGTGGTAATGCAGGAAT
CATATAACCGTTAAATGTG -> ATATAACCGTTAAATGTGG
CATATTGTCCTTCTGGCGT -> ATATTGTCCTTCTGGCGTG
CATCAGAAGATATTATAGG -> ATCAGAAGATATTATAGGT
CATCAGCCCTTCTGTTGTG -> ATCAGCCCTTCTGTTGTGT
CATCCAGGTCCTGCAGCGC -> ATCCAGGTCCTGCAGCGCA
CATCCGTGCACCACCAGTG -> ATCCGTGCACCACCAGTGA
CATCCTAAACAGTTGCCCT -> ATCCTAAACAGTTGCCCTT
CATCGGATCGATCCTGAGG -> ATCGGATCGATCCTGAGGG
CATGAGATAGTGCCAGCGG -> ATGAGATAGTGCCAGCGGA
CATGATCCTCCAAACGGAG -> ATGATCCTCCAAACGGAGC
CATGCAGGCCATATAACCG -> ATGCAGGCCATATAACCGT
CATGGAATGATAATATCCG -> ATGGAATGATAATATCCGG
CATGGCTGCGGCCCCGATG -> ATGGCTGCGGCCCCGATGC
CATGGGGAAGTAACTGAGA -> ATGGGGAAGTAACTGAGAT
CATGGGTGGAATTCGACTG -> ATGGGTGGAATTCGACTGG
CATGGGTTATGATAGAGAT -> ATGGGTTATGATAGAGATG
CATGTAACAGTGGTATGTC -> ATGTAACAGTGGTATGTCA
CATGTGGGGAATAGCCCAG -> ATGTGGGGAATAGCCCAGT
CATTACTCTTAGAGACTAT -> ATTACTCTTAGAGACTATG
CATTCCTTGGTTCGTTTAA -> ATTCCTTGGTTCGTTTAAT
CATTGCGGACCTGTCGAGC -> ATTGCGGACCTGTCGAGCT
CATTGTGAACCTACGCGAT -> ATTGTGAACCTACGCGATC
CATTTATCCCGTAAGGTGG -> ATTTATCCCGTAAGGTGGT
CATTTCCACCTAATCGCAA -> ATTTCCACCTAATCGCAAT
CATTTGGGTACCTCGATAT -> ATTTGGGTACCTCGATATG
CATTTTTAAACATTGTGAA -> ATTTTTAAACATTGTGAAC
CCAAACGGAGCACTGAAGC -> CAAACGGAGCACTGAAGCA
CCAACCGGACTGGGGCTCC -> CAACCGGACTGGGGCTCCT
CCAAGCAGGAGTGGAGGTT -> CAAGCAGGAGTGGAGGTTA
CCAAGCCCCGTTCGTTGAG -> CAAGCCCCGTTCGTTGAGT
CCAATCGTTGGATGTAGCT -> CAATCGTTGGATGTAGCTC
CCAATTGAGCTTCTACCCG -> CAATTGAGCTTCTACCCGC
CCACAAAGTCGGGTGTTCG -> CACAAAGTCGGGTGTTCGC
CCACCAAGCCCCGTTCGTT -> CACCAAGCCCCGTTCGTTG
CCACCAGTGAGACCCCGGG -> CACCAGTGAGACCCCGGGT
CCACCTAATCGCAATAGGT -> CACCTAATCGCAATAGGTA
CCACTGCCATAGCCTGCTC -> CACTGCCATAGCCTGCTCC
CCACTTATAGTACTGCGGT -> CACTTATAGTACTGCGGTC
CCAGACGGCTGCATGGGTT -> CAGACGGCTGCATGGGTTA
CCAGACGTAGCGGTTTGGT -> CAGACGTAGCGGTTTGGTA
CCAGATGGGAAAACTATTC -> CAGATGGGAAAACTATTCA
CCAGCCATTTGGGTACCTC -> CAGCCATTTGGGTACCTCG
CCAGCGGACGCCATCAGAA -> CAGCGGACGCCATCAGAAG
CCAGGAGTGTGATATCACC -> CAGGAGTGTGATATCACCT
CCAGGATGAATACGGTAAG -> CAGGATGAATACGGTAAGA
CCAGGCGGTCTCGGTCTCA -> CAGGCGGTCTCGGTCTCAA
CCAGGCTCACCTAACAATA -> CAGGCTCACCTAACAATAC
CCAGGTCCTGCAGCGCAGA -> CAGGTCCTGCAGCGCAGAA
CCAGTACAACCTAACAGAG -> CAGTACAACCTAACAGAGA
CCAGTGAGACCCCGGGTGC -> CAGTGAGACCCCGGGTGCA
CCAGTTAGCCCGAGTAATA -> CAGTTAGCCCGAGTAATAG
CCATAGCCTGCTCCCATGA -> CATAGCCTGCTCCCATGAT
CCATATAACCGTTAAATGT -> CATATAACCGTTAAATGTG
CCATATTGTCCTTCTGGCG -> CATATTGTCCTTCTGGCGT
CCATCAGAAGATATTATAG -> CATCAGAAGATATTATAGG
CCATGAGATAGTGCCAGCG -> CATGAGATAGTGCCAGCGG
CCATGATCCTCCAAACGGA -> CATGATCCTCCAAACGGAG
CCATGGCTGCGGCCCCGAT -> CATGGCTGCGGCCCCGATG
CCATTTCCACCTAATCGCA -> CATTTCCACCTAATCGCAA
CCATTTGGGTACCTCGATA -> CATTTGGGTACCTCGATAT
CCCACCAAGCCCCGTTCGT -> CCACCAAGCCCCGTTCGTT
CCCAGCCATTTGGGTACCT -> CCAGCCATTTGGGTACCTC
CCCAGGCTCACCTAACAAT -> CCAGGCTCACCTAACAATA
CCCAGTACAACCTAACAGA -> CCAGTACAACCTAACAGAG
CCCATGATCCTCCAAACGG -> CCATGATCCTCCAAACGGA
CCCCGATGCTTTCATGGAA -> CCCGATGCTTTCATGGAAT
CCCCGGGTGCAATACCCAG -> CCCGGGTGCAATACCCAGG
CCCCGTTCGTTGAGTAACC -> CCCGTTCGTTGAGTAACCG
CCCGAAATACGACCATTTC -> CCGAAATACGACCATTTCC
CCCGAGTAATAGTACAGGT -> CCGAGTAATAGTACAGGTC
CCCGATGCCCTGTAATTAA -> CCGATGCCCTGTAATTAAG
CCCGATGCTTTCATGGAAT -> CCGATGCTTTCATGGAATG
CCCGCAGCTCCCGGGGTGC -> CCGCAGCTCCCGGGGTGCC
CCCGCTAAGCACTGTGTAT -> CCGCTAAGCACTGTGTATC
CCCGCTTGGTAATGCAGGA -> CCGCTTGGTAATGCAGGAA
CCCGGAAGCTCCCGGGGTG -> CCGGAAGCTCCCGGGGTGC
CCCGGGGTGCCTGGATGAA -> CCGGGGTGCCTGGATGAAG
CCCGGGGTGCCTGGCCTGA -> CCGGGGTGCCTGGCCTGAC
CCCGGGGTGCCTGGGGGTC -> CCGGGGTGCCTGGGGGTCA
CCCGGGGTGCCTGGTACGC -> CCGGGGTGCCTGGTACGCC
CCCGGGTGCAATACCCAGG -> CCGGGTGCAATACCCAGGC
CCCGTAAGGTGGTCGTAGG -> CCGTAAGGTGGTCGTAGGC
CCCGTAATGCTAAATTCTT -> CCGTAATGCTAAATTCTTA
CCCGTTCGTTGAGTAACCG -> CCGTTCGTTGAGTAACCGG
CCCTGTAATTAAGTCACAG -> CCTGTAATTAAGTCACAGA
CCCTTCTGTTGTGTGGTAG -> CCTTCTGTTGTGTGGTAGG
CCCTTGTTAATCGTCTCCA -> CCTTGTTAATCGTCTCCAG
CCGAAATACGACCATTTCC -> CGAAATACGACCATTTCCA
CCGAATGTAATGTTCAGTA -> CGAATGTAATGTTCAGTAT
CCGAGTAATAGTACAGGTC -> CGAGTAATAGTACAGGTCT
CCGAGTTATTACGCATGGG -> CGAGTTATTACGCATGGGT
CCGATGACAAAGCCCAGCC -> CGATGACAAAGCCCAGCCA
CCGATGCCCTGTAATTAAG -> CGATGCCCTGTAATTAAGT
CCGATGCTTTCATGGAATG -> CGATGCTTTCATGGAATGA
CCGCAGCTCCCGGGGTGCC -> CGCAGCTCCCGGGGTGCCT
CCGCCCGATGCCCTGTAAT -> CGCCCGATGCCCTGTAATT
CCGCGTTAATACGAGGGGA -> CGCGTTAATACGAGGGGAA
CCGCTAAGCACTGTGTATC -> CGCTAAGCACTGTGTATCA
CCGCTTGGTAATGCAGGAA -> CGCTTGGTAATGCAGGAAT
CCGGAAGCTCCCGGGGTGC -> CGGAAGCTCCCGGGGTGCC
CCGGAATGCGAGACTTTAT -> CGGAATGCGAGACTTTATA
CCGGACTGGGGCTCCTCCT -> CGGACTGGGGCTCCTCCTT
CCGGGATAGGACATCCGTG -> CGGGATAGGACATCCGTGC
CCGGGGCGTACTGCGGCGT -> CGGGGCGTACTGCGGCGTC
CCGGGGTGCCTGGATGAAG -> CGGGGTGCCTGGATGAAGG
CCGGGGTGCCTGGCCTGAC -> CGGGGTGCCTGGCCTGACA
CCGGGGTGCCTGGGGGTCA -> CGGGGTGCCTGGGGGTCAG
CCGGGGTGCCTGGTACGCC -> CGGGGTGCCTGGTACGCCC
CCGGGTGCAATACCCAGGC -> CGGGTGCAATACCCAGGCT
CCGGTAATTATAGGGTCAT -> CGGTAATTATAGGGTCATT
CCGTAAGGTGGTCGTAGGC -> CGTAAGGTGGTCGTAGGCC
CCGTAATGCTAAATTCTTA -> CGTAATGCTAAATTCTTAA
CCGTGAGTGGGCCTAGCTC -> CGTGAGTGGGCCTAGCTCA
CCGTGCACCACCAGTGAGA -> CGTGCACCACCAGTGAGAC
CCGTTAAATGTGGCTGGCA -> CGTTAAATGTGGCTGGCAT
CCGTTATGGATATCTCATG -> CGTTATGGATATCTCATGT
CCGTTCGTTGAGTAACCGG -> CGTTCGTTGAGTAACCGGT
CCGTTCGTTGTGAGAGTCA -> CGTTCGTTGTGAGAGTCAT
CCTAAAATTATTCCAGGCG -> CTAAAATTATTCCAGGCGG
CCTAAACAGTTGCCCTTGT -> CTAAACAGTTGCCCTTGTT
CCTAACAATACCGTTCGTT -> CTAACAATACCGTTCGTTG
CCTAACAGAGAACAAAGCT -> CTAACAGAGAACAAAGCTC
CCTAATCGCAATAGGTATC -> CTAATCGCAATAGGTATCT
CCTACGCGATCAACTTATA -> CTACGCGATCAACTTATAA
CCTAGCTCAGATTCCAGGA -> CTAGCTCAGATTCCAGGAT
CCTATCCGTTATGGATATC -> CTATCCGTTATGGATATCT
CCTCAAAGTCTTCCATATT -> CTCAAAGTCTTCCATATTG
CCTCCAAACGGAGCACTGA -> CTCCAAACGGAGCACTGAA
CCTCCTTGATGCGAGGTTT -> CTCCTTGATGCGAGGTTTA
CCTCGATATGAGGTCCTTC -> CTCGATATGAGGTCCTTCG
CCTCTAAACGACAAAGCTC -> CTCTAAACGACAAAGCTCC
CCTCTTGTCCTAAAATTAT -> CTCTTGTCCTAAAATTATT
CCTGACATAGTGGTAATGC -> CTGACATAGTGGTAATGCA
CCTGAGGGCGACGTCACGT -> CTGAGGGCGACGTCACGTA
CCTGCAGCGCAGAATAACA -> CTGCAGCGCAGAATAACAC
CCTGCTCCCATGATCCTCC -> CTGCTCCCATGATCCTCCA
CCTGGATACTGTGCTGGTA -> CTGGATACTGTGCTGGTAC
CCTGGATGAAGGCGAAGGT -> CTGGATGAAGGCGAAGGTA
CCTGGCCTGACATAGTGGT -> CTGGCCTGACATAGTGGTA
CCTGGGGGTCAGGCGTGGT -> CTGGGGGTCAGGCGTGGTA
CCTGGTACGCCCGCTTGGT -> CTGGTACGCCCGCTTGGTA
CCTGTAATTAAGTCACAGA -> CTGTAATTAAGTCACAGAG
CCTGTCGAGCTCCCGGGGT -> CTGTCGAGCTCCCGGGGTG
CCTTAACATGCAGGCCATA -> CTTAACATGCAGGCCATAT
CCTTCGATAGGCCGTGAGT -> CTTCGATAGGCCGTGAGTG
CCTTCTGGCGTGACTTTGT -> CTTCTGGCGTGACTTTGTC
CCTTCTGTTGTGTGGTAGG -> CTTCTGTTGTGTGGTAGGC
CCTTGATGCGAGGTTTAGG -> CTTGATGCGAGGTTTAGGA
CCTTGGTTCGTTTAATAGA -> CTTGGTTCGTTTAATAGAG
CCTTGTTAATCGTCTCCAG -> CTTGTTAATCGTCTCCAGA
CGAAATACGACCATTTCCA -> GAAATACGACCATTTCCAC
CGAAGGTAATGCAGGAATG -> GAAGGTAATGCAGGAATGA
CGAATAGTCCCGAAATACG -> GAATAGTCCCGAAATACGA
CGAATGTAATGTTCAGTAT -> GAATGTAATGTTCAGTATA
CGAATTACTTACACCGCGT -> GAATTACTTACACCGCGTT
CGACAAAGCTCCAAGCAGG -> GACAAAGCTCCAAGCAGGA
CGACATAAGGCGGTCATCC -> GACATAAGGCGGTCATCCT
CGACCATTTCCACCTAATC -> GACCATTTCCACCTAATCG
CGACCTCTTGTCCTAAAAT -> GACCTCTTGTCCTAAAATT
CGACGTCACGTAGTGGAAG -> GACGTCACGTAGTGGAAGG
CGACTGGGAATAGAAAAAT -> GACTGGGAATAGAAAAATC
CGACTTTCGAATAGTCCCG -> GACTTTCGAATAGTCCCGA
CGAGACCAATCGTTGGATG -> GAGACCAATCGTTGGATGT
CGAGACTTTATATTTTGCT -> GAGACTTTATATTTTGCTC
CGAGAGAAGCGGTGTCGGC -> GAGAGAAGCGGTGTCGGCA
CGAGCTCCCGGGGTGCCTG -> GAGCTCCCGGGGTGCCTGG
CGAGGGGAAGATGAAGATA -> GAGGGGAAGATGAAGATAG
CGAGGGTATTCCATGGCTG -> GAGGGTATTCCATGGCTGC
CGAGGTTTAGGAAGTTAGT -> GAGGTTTAGGAAGTTAGTG
CGAGTAATAGTACAGGTCT -> GAGTAATAGTACAGGTCTT
CGAGTTATTACGCATGGGT -> GAGTTATTACGCATGGGTG
CGATAGGCCGTGAGTGGGC -> GATAGGCCGTGAGTGGGCC
CGATATGAGGTCCTTCGAT -> GATATGAGGTCCTTCGATA
CGATCAACTTATAACGGAA -> GATCAACTTATAACGGAAC
CGATCACTAACTAGGCGGC -> GATCACTAACTAGGCGGCG
CGATCCTGAGGGCGACGTC -> GATCCTGAGGGCGACGTCA
CGATGACAAAGCCCAGCCA -> GATGACAAAGCCCAGCCAT
CGATGCCCTGTAATTAAGT -> GATGCCCTGTAATTAAGTC
CGATGCTTTCATGGAATGA -> GATGCTTTCATGGAATGAT
CGATTTGTTACTTTCCGAG -> GATTTGTTACTTTCCGAGT
CGCAAATTTAGCGAGAGAA -> GCAAATTTAGCGAGAGAAG
CGCAATAGGTATCTTCATA -> GCAATAGGTATCTTCATAA
CGCAGAAAGTGCGACATAA -> GCAGAAAGTGCGACATAAG
CGCAGAATAACACGAGACC -> GCAGAATAACACGAGACCA
CGCAGCGAATTACTTACAC -> GCAGCGAATTACTTACACC
CGCAGCTCCCGGGGTGCCT -> GCAGCTCCCGGGGTGCCTG
CGCAGGTATCAGACAAGAA -> GCAGGTATCAGACAAGAAA
CGCATGGGTGGAATTCGAC -> GCATGGGTGGAATTCGACT
CGCCAGTTAGCCCGAGTAA -> GCCAGTTAGCCCGAGTAAT
CGCCATCAGAAGATATTAT -> GCCATCAGAAGATATTATA
CGCCCGATGCCCTGTAATT -> GCCCGATGCCCTGTAATTA
CGCCCGCAGCTCCCGGGGT -> GCCCGCAGCTCCCGGGGTG
CGCCCGCTTGGTAATGCAG -> GCCCGCTTGGTAATGCAGG
CGCGATCAACTTATAACGG -> GCGATCAACTTATAACGGA
CGCGCGCGCTAATAGCTCC -> GCGCGCGCTAATAGCTCCC
CGCGCGCTAATAGCTCCCG -> GCGCGCTAATAGCTCCCGG
CGCGCTAATAGCTCCCGGG -> GCGCTAATAGCTCCCGGGG
CGCGCTCAAAGCGCGTTAA -> GCGCTCAAAGCGCGTTAAG
CGCGGATCCAGGAGTGTGA -> GCGGATCCAGGAGTGTGAT
CGCGGTTGTTCCAATTGAG -> GCGGTTGTTCCAATTGAGC
CGCGTTAAGTAGCTCTTTG -> GCGTTAAGTAGCTCTTTGC
CGCGTTAATACGAGGGGAA -> GCGTTAATACGAGGGGAAG
CGCTAAGCACTGTGTATCA -> GCTAAGCACTGTGTATCAC
CGCTAATAGCTCCCGGGGT -> GCTAATAGCTCCCGGGGTG
CGCTCAAAGCGCGTTAAGT -> GCTCAAAGCGCGTTAAGTA
CGCTCTGAGCAAAGGGACC -> GCTCTGAGCAAAGGGACCG
CGCTTGGTAATGCAGGAAT -> GCTTGGTAATGCAGGAATG
CGGAACTGGGGGAACCAAC -> GGAACTGGGGGAACCAACC
CGGAAGCTCCCGGGGTGCC -> GGAAGCTCCCGGGGTGCCT
CGGAATGCGAGACTTTATA -> GGAATGCGAGACTTTATAT
CGGACATAAGTCGCGCTCA -> GGACATAAGTCGCGCTCAA
CGGACCTGTCGAGCTCCCG -> GGACCTGTCGAGCTCCCGG
CGGACGCCATCAGAAGATA -> GGACGCCATCAGAAGATAT
CGGACTGGGGCTCCTCCTT -> GGACTGGGGCTCCTCCTTG
CGGAGCACTGAAGCAATGC -> GGAGCACTGAAGCAATGCT
CGGATCCAGGAGTGTGATA -> GGATCCAGGAGTGTGATAT
CGGATCGATCCTGAGGGCG -> GGATCGATCCTGAGGGCGA
CGGCACCAGACGGCTGCAT -> GGCACCAGACGGCTGCATG
CGGCACTAAATCCCGTAAT -> GGCACTAAATCCCGTAATG
CGGCAGACGCGGTTGTTCC -> GGCAGACGCGGTTGTTCCA
CGGCCCCGATGCTTTCATG -> GGCCCCGATGCTTTCATGG
CGGCGCAGAAAGTGCGACA -> GGCGCAGAAAGTGCGACAT
CGGCGTCATAAGAGGGAGC -> GGCGTCATAAGAGGGAGCT
CGGCGTCGACCTCTTGTCC -> GGCGTCGACCTCTTGTCCT
CGGCTGCATGGGTTATGAT -> GGCTGCATGGGTTATGATA
CGGGATAGGACATCCGTGC -> GGGATAGGACATCCGTGCA
CGGGATGACGTCGCAGCGA -> GGGATGACGTCGCAGCGAA
CGGGGCGTACTGCGGCGTC -> GGGGCGTACTGCGGCGTCG
CGGGGTGCCTGGATGAAGG -> GGGGTGCCTGGATGAAGGC
CGGGGTGCCTGGCCTGACA -> GGGGTGCCTGGCCTGACAT
CGGGGTGCCTGGGGGTCAG -> GGGGTGCCTGGGGGTCAGG
CGGGGTGCCTGGTACGCCC -> GGGGTGCCTGGTACGCCCG
CGGGTGCAATACCCAGGCT -> GGGTGCAATACCCAGGCTC
CGGGTGTTCGCCCGCAGCT -> GGGTGTTCGCCCGCAGCTC
CGGTAAGATGGGCCGGAAT -> GGTAAGATGGGCCGGAATG
CGGTAATTATAGGGTCATT -> GGTAATTATAGGGTCATTG
CGGTCATCCTAAACAGTTG -> GGTCATCCTAAACAGTTGC
CGGTCGCTCTGAGCAAAGG -> GGTCGCTCTGAGCAAAGGG
CGGTCTCAAGGGATTATAC -> GGTCTCAAGGGATTATACC
CGGTCTCGGTCTCAAGGGA -> GGTCTCGGTCTCAAGGGAT
CGGTGTCGGCACCAGACGG -> GGTGTCGGCACCAGACGGC
CGGTTGACCTCTAAACGAC -> GGTTGACCTCTAAACGACA
CGGTTGTTCCAATTGAGCT -> GGTTGTTCCAATTGAGCTT
CGGTTTGGTAAAATGTCTC -> GGTTTGGTAAAATGTCTCA
CGTAAGGTGGTCGTAGGCC -> GTAAGGTGGTCGTAGGCCA
CGTAATGCTAAATTCTTAA -> GTAATGCTAAATTCTTAAC
CGTACTGCGGCGTCGACCT -> GTACTGCGGCGTCGACCTC
CGTAGCGGTTTGGTAAAAT -> GTAGCGGTTTGGTAAAATG
CGTAGGCCACTGCCATAGC -> GTAGGCCACTGCCATAGCC
CGTAGTGGAAGGCGGACAT -> GTAGTGGAAGGCGGACATA
CGTCACGTAGTGGAAGGCG -> GTCACGTAGTGGAAGGCGG
CGTCATAAGAGGGAGCTAT -> GTCATAAGAGGGAGCTATC
CGTCGACCTCTTGTCCTAA -> GTCGACCTCTTGTCCTAAA
CGTCGCAGCGAATTACTTA -> GTCGCAGCGAATTACTTAC
CGTCTCCAGACGTAGCGGT -> GTCTCCAGACGTAGCGGTT
CGTGACTTTGTCTCAACGG -> GTGACTTTGTCTCAACGGC
CGTGAGTGGGCCTAGCTCA -> GTGAGTGGGCCTAGCTCAG
CGTGCACCACCAGTGAGAC -> GTGCACCACCAGTGAGACC
CGTGGTAATGCAGGAATGA -> GTGGTAATGCAGGAATGAA
CGTGTCAAGTCAGCGGCAG -> GTGTCAAGTCAGCGGCAGA
CGTTAAATGTGGCTGGCAT -> GTTAAATGTGGCTGGCATC
CGTTAAGTAGCTCTTTGCA -> GTTAAGTAGCTCTTTGCAC
CGTTAATACGAGGGGAAGA -> GTTAATACGAGGGGAAGAT
CGTTATGGATATCTCATGT -> GTTATGGATATCTCATGTA
CGTTCGTTGAGTAACCGGT -> GTTCGTTGAGTAACCGGTA
CGTTCGTTGTGAGAGTCAT -> GTTCGTTGTGAGAGTCATA
CGTTGAGTAACCGGTAATT -> GTTGAGTAACCGGTAATTA
CGTTGGATGTAGCTCGTGT -> GTTGGATGTAGCTCGTGTC
CGTTGTGAGAGTCATAGAC -> GTTGTGAGAGTCATAGACC
CGTTTAATAGAGGTACTGG -> GTTTAATAGAGGTACTGGT
CTAAAATTATTCCAGGCGG -> TAAAATTATTCCAGGCGGT
CTAAACAGTTGCCCTTGTT -> TAAACAGTTGCCCTTGTTA
CTAAACGACAAAGCTCCAA -> TAAACGACAAAGCTCCAAG
CTAAATCCCGTAATGCTAA -> TAAATCCCGTAATGCTAAA
CTAAATTCTTAACAGCGCG -> TAAATTCTTAACAGCGCGG
CTAACAATACCGTTCGTTG -> TAACAATACCGTTCGTTGT
CTAACAGAGAACAAAGCTC -> TAACAGAGAACAAAGCTCC
CTAACTAGGCGGCGCAGAA -> TAACTAGGCGGCGCAGAAA
CTAAGCACTGTGTATCACA -> TAAGCACTGTGTATCACAT
CTAATAGCTCCCGGGGTGC -> TAATAGCTCCCGGGGTGCC
CTAATCGCAATAGGTATCT -> TAATCGCAATAGGTATCTT
CTACAAAGGAACGCGCGCG -> TACAAAGGAACGCGCGCGC
CTACCCGCTAAGCACTGTG -> TACCCGCTAAGCACTGTGT
CTACGCGATCAACTTATAA -> TACGCGATCAACTTATAAC
CTAGACGGCGTCATAAGAG -> TAGACGGCGTCATAAGAGG
CTAGCTCAGATTCCAGGAT -> TAGCTCAGATTCCAGGATG
CTAGGCGGCGCAGAAAGTG -> TAGGCGGCGCAGAAAGTGC
CTATCCAGATGGGAAAACT -> TATCCAGATGGGAAAACTA
CTATCCGTTATGGATATCT -> TATCCGTTATGGATATCTC
CTATGTAGTATCACAAGTA -> TATGTAGTATCACAAGTAG
CTATTCATCCAGGTCCTGC -> TATTCATCCAGGTCCTGCA
CTCAAAGCGCGTTAAGTAG -> TCAAAGCGCGTTAAGTAGC
CTCAAAGTCTTCCATATTG -> TCAAAGTCTTCCATATTGT
CTCAACGGCACTAAATCCC -> TCAACGGCACTAAATCCCG
CTCAAGGGATTATACCACT -> TCAAGGGATTATACCACTT
CTCACCTAACAATACCGTT -> TCACCTAACAATACCGTTC
CTCAGATTCCAGGATGAAT -> TCAGATTCCAGGATGAATA
CTCAGCGAGGGTATTCCAT -> TCAGCGAGGGTATTCCATG
CTCATAATCCAGCGCCGCA -> TCATAATCCAGCGCCGCAT
CTCATGTAACAGTGGTATG -> TCATGTAACAGTGGTATGT
CTCATTTTTAAACATTGTG -> TCATTTTTAAACATTGTGA
CTCCAAACGGAGCACTGAA -> TCCAAACGGAGCACTGAAG
CTCCAAGCAGGAGTGGAGG -> TCCAAGCAGGAGTGGAGGT
CTCCAGACGTAGCGGTTTG -> TCCAGACGTAGCGGTTTGG
CTCCCATGATCCTCCAAAC -> TCCCATGATCCTCCAAACG
CTCCCGGGGTGCCTGGATG -> TCCCGGGGTGCCTGGATGA
CTCCCGGGGTGCCTGGCCT -> TCCCGGGGTGCCTGGCCTG
CTCCCGGGGTGCCTGGGGG -> TCCCGGGGTGCCTGGGGGT
CTCCCGGGGTGCCTGGTAC -> TCCCGGGGTGCCTGGTACG
CTCCTATCCGTTATGGATA -> TCCTATCCGTTATGGATAT
CTCCTCCTTGATGCGAGGT -> TCCTCCTTGATGCGAGGTT
CTCCTTGATGCGAGGTTTA -> TCCTTGATGCGAGGTTTAG
CTCGATATGAGGTCCTTCG -> TCGATATGAGGTCCTTCGA
CTCGGTCTCAAGGGATTAT -> TCGGTCTCAAGGGATTATA
CTCGTGTCAAGTCAGCGGC -> TCGTGTCAAGTCAGCGGCA
CTCTAAACGACAAAGCTCC -> TCTAAACGACAAAGCTCCA
CTCTGAGCAAAGGGACCGG -> TCTGAGCAAAGGGACCGGG
CTCTTAGAGACTATGTAGT -> TCTTAGAGACTATGTAGTA
CTCTTGTCCTAAAATTATT -> TCTTGTCCTAAAATTATTC
CTCTTTGCACAAAATCAAT -> TCTTTGCACAAAATCAATT
CTGAAGCAATGCTTGGCGC -> TGAAGCAATGCTTGGCGCA
CTGACATAGTGGTAATGCA -> TGACATAGTGGTAATGCAG
CTGAGATACAGATACCTGG -> TGAGATACAGATACCTGGA
CTGAGCAAAGGGACCGGGA -> TGAGCAAAGGGACCGGGAT
CTGAGGGCGACGTCACGTA -> TGAGGGCGACGTCACGTAG
CTGCAGCGCAGAATAACAC -> TGCAGCGCAGAATAACACG
CTGCATGGGTTATGATAGA -> TGCATGGGTTATGATAGAG
CTGCCATAGCCTGCTCCCA -> TGCCATAGCCTGCTCCCAT
CTGCGGCCCCGATGCTTTC -> TGCGGCCCCGATGCTTTCA
CTGCGGCGTCGACCTCTTG -> TGCGGCGTCGACCTCTTGT
CTGCGGTCGCTCTGAGCAA -> TGCGGTCGCTCTGAGCAAA
CTGCTCCCATGATCCTCCA -> TGCTCCCATGATCCTCCAA
CTGGATACTGTGCTGGTAC -> TGGATACTGTGCTGGTACT
CTGGATGAAGGCGAAGGTA -> TGGATGAAGGCGAAGGTAA
CTGGCATCAGCCCTTCTGT -> TGGCATCAGCCCTTCTGTT
CTGGCCTGACATAGTGGTA -> TGGCCTGACATAGTGGTAA
CTGGCGTGACTTTGTCTCA -> TGGCGTGACTTTGTCTCAA
CTGGGAATAGAAAAATCTT -> TGGGAATAGAAAAATCTTC
CTGGGGCTCCTCCTTGATG -> TGGGGCTCCTCCTTGATGC
CTGGGGGAACCAACCGGAC -> TGGGGGAACCAACCGGACT
CTGGGGGTCAGGCGTGGTA -> TGGGGGTCAGGCGTGGTAA
CTGGTACGCCCGCTTGGTA -> TGGTACGCCCGCTTGGTAA
CTGGTACTAGACGGCGTCA -> TGGTACTAGACGGCGTCAT
CTGGTTAACTTGTTGACGA -> TGGTTAACTTGTTGACGAC
CTGGTTTAGGCGATTTGTT -> TGGTTTAGGCGATTTGTTA
CTGTAATTAAGTCACAGAG -> TGTAATTAAGTCACAGAGC
CTGTATTTATATAACACTT -> TGTATTTATATAACACTTG
CTGTCGAGCTCCCGGGGTG -> TGTCGAGCTCCCGGGGTGC
CTGTCGCAAATTTAGCGAG -> TGTCGCAAATTTAGCGAGA
CTGTGCTGGTACTAGACGG -> TGTGCTGGTACTAGACGGC
CTGTGTATCACATGTGGGG -> TGTGTATCACATGTGGGGA
CTGTTCAGAGGGCGCCAGT -> TGTTCAGAGGGCGCCAGTT
CTGTTGTGTGGTAGGCATT -> TGTTGTGTGGTAGGCATTT
CTTAACAGCGCGGATCCAG -> TTAACAGCGCGGATCCAGG
CTTAACATGCAGGCCATAT -> TTAACATGCAGGCCATATA
CTTACACCGCGTTAATACG -> TTACACCGCGTTAATACGA
CTTAGAGACTATGTAGTAT -> TTAGAGACTATGTAGTATC
CTTAGCCGAATGTAATGTT -> TTAGCCGAATGTAATGTTC
CTTATAACGGAACTGGGGG -> TTATAACGGAACTGGGGGA
CTTATAGTACTGCGGTCGC -> TTATAGTACTGCGGTCGCT
CTTCACACGATCACTAACT -> TTCACACGATCACTAACTA
CTTCATAAGGTCCGCCCGA -> TTCATAAGGTCCGCCCGAT
CTTCCATATTGTCCTTCTG -> TTCCATATTGTCCTTCTGG
CTTCGATAGGCCGTGAGTG -> TTCGATAGGCCGTGAGTGG
CTTCTACAAAGGAACGCGC -> TTCTACAAAGGAACGCGCG
CTTCTACCCGCTAAGCACT -> TTCTACCCGCTAAGCACTG
CTTCTGGCGTGACTTTGTC -> TTCTGGCGTGACTTTGTCT
CTTCTGTTGTGTGGTAGGC -> TTCTGTTGTGTGGTAGGCA
CTTGATGCGAGGTTTAGGA -> TTGATGCGAGGTTTAGGAA
CTTGCAACTGTCGCAAATT -> TTGCAACTGTCGCAAATTT
CTTGGAGGTGAGAGAAATA -> TTGGAGGTGAGAGAAATAA
CTTGGCGCAGGTATCAGAC -> TTGGCGCAGGTATCAGACA
CTTGGTAATGCAGGAATGA -> TTGGTAATGCAGGAATGAA
CTTGGTTCGTTTAATAGAG -> TTGGTTCGTTTAATAGAGG
CTTGTCCTAAAATTATTCC -> TTGTCCTAAAATTATTCCA
CTTGTGTTTGGGGTCCGAT -> TTGTGTTTGGGGTCCGATG
CTTGTTAATCGTCTCCAGA -> TTGTTAATCGTCTCCAGAC
CTTGTTGACGACTTTCGAA -> TTGTTGACGACTTTCGAAT
CTTTATATTTTGCTCATAA -> TTTATATTTTGCTCATAAT
CTTTCATGGAATGATAATA -> TTTCATGGAATGATAATAT
CTTTCCGAGTTATTACGCA -> TTTCCGAGTTATTACGCAT
CTTTCGAATAGTCCCGAAA -> TTTCGAATAGTCCCGAAAT
CTTTGCACAAAATCAATTC -> TTTGCACAAAATCAATTCT
CTTTGGCGGGATGACGTCG -> TTTGGCGGGATGACGTCGC
CTTTGTCTCAACGGCACTA -> TTTGTCTCAACGGCACTAA
GAAAAATCTTCACACGATC -> AAAAATCTTCACACGATCA
GAAAACTATTCATCCAGGT -> AAAACTATTCATCCAGGTC
GAAAAGCTTGCAACTGTCG -> AAAAGCTTGCAACTGTCGC
GAAAGTGCGACATAAGGCG -> AAAGTGCGACATAAGGCGG
GAAATAATCCACAAAGTCG -> AAATAATCCACAAAGTCGG
GAAATACGACCATTTCCAC -> AAATACGACCATTTCCACC
GAACAAAGCTCCTATCCGT -> AACAAAGCTCCTATCCGTT
GAACAAATCTCATTTTTAA -> AACAAATCTCATTTTTAAA
GAACAATCGGTTGACCTCT -> AACAATCGGTTGACCTCTA
GAACATGGGGAAGTAACTG -> AACATGGGGAAGTAACTGA
GAACATTACTCTTAGAGAC -> AACATTACTCTTAGAGACT
GAACCAACCGGACTGGGGC -> AACCAACCGGACTGGGGCT
GAACCTACGCGATCAACTT -> AACCTACGCGATCAACTTA
GAACGCGCGCGCTAATAGC -> AACGCGCGCGCTAATAGCT
GAACTGGGGGAACCAACCG -> AACTGGGGGAACCAACCGG
GAAGATAGTATTTGCCCGG -> AAGATAGTATTTGCCCGGA
GAAGATATTATAGGTATTC -> AAGATATTATAGGTATTCT
GAAGATGAAGATAGTATTT -> AAGATGAAGATAGTATTTG
GAAGCAATGCTTGGCGCAG -> AAGCAATGCTTGGCGCAGG
GAAGCGGTGTCGGCACCAG -> AAGCGGTGTCGGCACCAGA
GAAGCTCCCGGGGTGCCTG -> AAGCTCCCGGGGTGCCTGG
GAAGGCGAAGGTAATGCAG -> AAGGCGAAGGTAATGCAGG
GAAGGCGGACATAAGTCGC -> AAGGCGGACATAAGTCGCG
GAAGGTAATGCAGGAATGA -> AAGGTAATGCAGGAATGAA
GAAGTAACTGAGATACAGA -> AAGTAACTGAGATACAGAT
GAAGTTAGTGAGAGTGCTG -> AAGTTAGTGAGAGTGCTGG
GAATAACACGAGACCAATC -> AATAACACGAGACCAATCG
GAATACGGTAAGATGGGCC -> AATACGGTAAGATGGGCCG
GAATAGAAAAATCTTCACA -> AATAGAAAAATCTTCACAC
GAATAGCCCAGTACAACCT -> AATAGCCCAGTACAACCTA
GAATAGTCCCGAAATACGA -> AATAGTCCCGAAATACGAC
GAATGAACAAATCTCATTT -> AATGAACAAATCTCATTTT
GAATGAACAATCGGTTGAC -> AATGAACAATCGGTTGACC
GAATGAACATGGGGAAGTA -> AATGAACATGGGGAAGTAA
GAATGAACATTACTCTTAG -> AATGAACATTACTCTTAGA
GAATGATAATATCCGGGGC -> AATGATAATATCCGGGGCG
GAATGCGAGACTTTATATT -> AATGCGAGACTTTATATTT
GAATGTAATGTTCAGTATA -> AATGTAATGTTCAGTATAA
GAATTACTTACACCGCGTT -> AATTACTTACACCGCGTTA
GAATTCGACTGGGAATAGA -> AATTCGACTGGGAATAGAA
GACAAAGCCCAGCCATTTG -> ACAAAGCCCAGCCATTTGG
GACAAAGCTCCAAGCAGGA -> ACAAAGCTCCAAGCAGGAG
GACAAGAAAAGCTTGCAAC -> ACAAGAAAAGCTTGCAACT
GACATAAGGCGGTCATCCT -> ACATAAGGCGGTCATCCTA
GACATAAGTCGCGCTCAAA -> ACATAAGTCGCGCTCAAAG
GACATAGTGGTAATGCAGG -> ACATAGTGGTAATGCAGGA
GACATCCGTGCACCACCAG -> ACATCCGTGCACCACCAGT
GACCAATCGTTGGATGTAG -> ACCAATCGTTGGATGTAGC
GACCATTTCCACCTAATCG -> ACCATTTCCACCTAATCGC
GACCCCGGGTGCAATACCC -> ACCCCGGGTGCAATACCCA
GACCGGGATAGGACATCCG -> ACCGGGATAGGACATCCGT
GACCTCAAAGTCTTCCATA -> ACCTCAAAGTCTTCCATAT
GACCTCTAAACGACAAAGC -> ACCTCTAAACGACAAAGCT
GACCTCTTGTCCTAAAATT -> ACCTCTTGTCCTAAAATTA
GACCTGTCGAGCTCCCGGG -> ACCTGTCGAGCTCCCGGGG
GACGACTTTCGAATAGTCC -> ACGACTTTCGAATAGTCCC
GACGCCATCAGAAGATATT -> ACGCCATCAGAAGATATTA
GACGCGGTTGTTCCAATTG -> ACGCGGTTGTTCCAATTGA
GACGGCGTCATAAGAGGGA -> ACGGCGTCATAAGAGGGAG
GACGGCTGCATGGGTTATG -> ACGGCTGCATGGGTTATGA
GACGTAGCGGTTTGGTAAA -> ACGTAGCGGTTTGGTAAAA
GACGTCACGTAGTGGAAGG -> ACGTCACGTAGTGGAAGGC
GACGTCGCAGCGAATTACT -> ACGTCGCAGCGAATTACTT
GACTATGTAGTATCACAAG -> ACTATGTAGTATCACAAGT
GACTGGGAATAGAAAAATC -> ACTGGGAATAGAAAAATCT
GACTGGGGCTCCTCCTTGA -> ACTGGGGCTCCTCCTTGAT
GACTTTATATTTTGCTCAT -> ACTTTATATTTTGCTCATA
GACTTTCGAATAGTCCCGA -> ACTTTCGAATAGTCCCGAA
GACTTTGTCTCAACGGCAC -> ACTTTGTCTCAACGGCACT
GAGAAATAATCCACAAAGT -> AGAAATAATCCACAAAGTC
GAGAACAAAGCTCCTATCC -> AGAACAAAGCTCCTATCCG
GAGAAGCGGTGTCGGCACC -> AGAAGCGGTGTCGGCACCA
GAGACCAATCGTTGGATGT -> AGACCAATCGTTGGATGTA
GAGACCCCGGGTGCAATAC -> AGACCCCGGGTGCAATACC
GAGACTATGTAGTATCACA -> AGACTATGTAGTATCACAA
GAGACTTTATATTTTGCTC -> AGACTTTATATTTTGCTCA
GAGAGAAATAATCCACAAA -> AGAGAAATAATCCACAAAG
GAGAGAAGCGGTGTCGGCA -> AGAGAAGCGGTGTCGGCAC
GAGAGTCATAGACCTCAAA -> AGAGTCATAGACCTCAAAG
GAGAGTGCTGGTTAACTTG -> AGAGTGCTGGTTAACTTGT
GAGATACAGATACCTGGAT -> AGATACAGATACCTGGATA
GAGATAGTGCCAGCGGACG -> AGATAGTGCCAGCGGACGC
GAGATGCTTAGCCGAATGT -> AGATGCTTAGCCGAATGTA
GAGCAAAGGGACCGGGATA -> AGCAAAGGGACCGGGATAG
GAGCACTGAAGCAATGCTT -> AGCACTGAAGCAATGCTTG
GAGCCCACCAAGCCCCGTT -> AGCCCACCAAGCCCCGTTC
GAGCTATCCAGATGGGAAA -> AGCTATCCAGATGGGAAAA
GAGCTCCCGGGGTGCCTGG -> AGCTCCCGGGGTGCCTGGG
GAGCTTCTACCCGCTAAGC -> AGCTTCTACCCGCTAAGCA
GAGGGAGCTATCCAGATGG -> AGGGAGCTATCCAGATGGG
GAGGGCGACGTCACGTAGT -> AGGGCGACGTCACGTAGTG
GAGGGCGCCAGTTAGCCCG -> AGGGCGCCAGTTAGCCCGA
GAGGGGAAGATGAAGATAG -> AGGGGAAGATGAAGATAGT
GAGGGTATTCCATGGCTGC -> AGGGTATTCCATGGCTGCG
GAGGTACTGGTTTAGGCGA -> AGGTACTGGTTTAGGCGAT
GAGGTCCTTCGATAGGCCG -> AGGTCCTTCGATAGGCCGT
GAGGTGAGAGAAATAATCC -> AGGTGAGAGAAATAATCCA
GAGGTTACATTCCTTGGTT -> AGGTTACATTCCTTGGTTC
GAGGTTTAGGAAGTTAGTG -> AGGTTTAGGAAGTTAGTGA
GAGTAACCGGTAATTATAG -> AGTAACCGGTAATTATAGG
GAGTAATAGTACAGGTCTT -> AGTAATAGTACAGGTCTTC
GAGTCATAGACCTCAAAGT -> AGTCATAGACCTCAAAGTC
GAGTGCTGGTTAACTTGTT -> AGTGCTGGTTAACTTGTTG
GAGTGGAGGTTACATTCCT -> AGTGGAGGTTACATTCCTT
GAGTGGGCCTAGCTCAGAT -> AGTGGGCCTAGCTCAGATT
GAGTGTGATATCACCTTAA -> AGTGTGATATCACCTTAAC
GAGTTATTACGCATGGGTG -> AGTTATTACGCATGGGTGG
GATAATATCCGGGGCGTAC -> ATAATATCCGGGGCGTACT
GATACAGATACCTGGATAC -> ATACAGATACCTGGATACT
GATACCTGGATACTGTGCT -> ATACCTGGATACTGTGCTG
GATACTGTGCTGGTACTAG -> ATACTGTGCTGGTACTAGA
GATAGAGATGCTTAGCCGA -> ATAGAGATGCTTAGCCGAA
GATAGGACATCCGTGCACC -> ATAGGACATCCGTGCACCA
GATAGGCCGTGAGTGGGCC -> ATAGGCCGTGAGTGGGCCT
GATAGTATTTGCCCGGAAG -> ATAGTATTTGCCCGGAAGC
GATAGTGCCAGCGGACGCC -> ATAGTGCCAGCGGACGCCA
GATATCACCTTAACATGCA -> ATATCACCTTAACATGCAG
GATATCTCATGTAACAGTG -> ATATCTCATGTAACAGTGG
GATATGAGGTCCTTCGATA -> ATATGAGGTCCTTCGATAG
GATATTATAGGTATTCTTT -> ATATTATAGGTATTCTTTG
GATCAACTTATAACGGAAC -> ATCAACTTATAACGGAACT
GATCACTAACTAGGCGGCG -> ATCACTAACTAGGCGGCGC
GATCATCGGATCGATCCTG -> ATCATCGGATCGATCCTGA
GATCCAGGAGTGTGATATC -> ATCCAGGAGTGTGATATCA
GATCCTCCAAACGGAGCAC -> ATCCTCCAAACGGAGCACT
GATCCTGAGGGCGACGTCA -> ATCCTGAGGGCGACGTCAC
GATCGATCCTGAGGGCGAC -> ATCGATCCTGAGGGCGACG
GATGAAGATAGTATTTGCC -> ATGAAGATAGTATTTGCCC
GATGAAGGCGAAGGTAATG -> ATGAAGGCGAAGGTAATGC
GATGAATACGGTAAGATGG -> ATGAATACGGTAAGATGGG
GATGACAAAGCCCAGCCAT -> ATGACAAAGCCCAGCCATT
GATGACGTCGCAGCGAATT -> ATGACGTCGCAGCGAATTA
GATGCCCTGTAATTAAGTC -> ATGCCCTGTAATTAAGTCA
GATGCGAGGTTTAGGAAGT -> ATGCGAGGTTTAGGAAGTT
GATGCTTAGCCGAATGTAA -> ATGCTTAGCCGAATGTAAT
GATGCTTTCATGGAATGAT -> ATGCTTTCATGGAATGATA
GATGGGAAAACTATTCATC -> ATGGGAAAACTATTCATCC
GATGGGCCGGAATGCGAGA -> ATGGGCCGGAATGCGAGAC
GATGTAGCTCGTGTCAAGT -> ATGTAGCTCGTGTCAAGTC
GATTATACCACTTATAGTA -> ATTATACCACTTATAGTAC
GATTCCAGGATGAATACGG -> ATTCCAGGATGAATACGGT
GATTTGTTACTTTCCGAGT -> ATTTGTTACTTTCCGAGTT
GCAAAGGGACCGGGATAGG -> CAAAGGGACCGGGATAGGA
GCAAATTTAGCGAGAGAAG -> CAAATTTAGCGAGAGAAGC
GCAACTGTCGCAAATTTAG -> CAACTGTCGCAAATTTAGC
GCAATACCCAGGCTCACCT -> CAATACCCAGGCTCACCTA
GCAATAGGTATCTTCATAA -> CAATAGGTATCTTCATAAG
GCAATGCTTGGCGCAGGTA -> CAATGCTTGGCGCAGGTAT
GCACAAAATCAATTCTGTT -> CACAAAATCAATTCTGTTC
GCACCACCAGTGAGACCCC -> CACCACCAGTGAGACCCCG
GCACCAGACGGCTGCATGG -> CACCAGACGGCTGCATGGG
GCACCATGAGATAGTGCCA -> CACCATGAGATAGTGCCAG
GCACTAAATCCCGTAATGC -> CACTAAATCCCGTAATGCT
GCACTGAAGCAATGCTTGG -> CACTGAAGCAATGCTTGGC
GCACTGTGTATCACATGTG -> CACTGTGTATCACATGTGG
GCAGAAAGTGCGACATAAG -> CAGAAAGTGCGACATAAGG
GCAGAATAACACGAGACCA -> CAGAATAACACGAGACCAA
GCAGACGCGGTTGTTCCAA -> CAGACGCGGTTGTTCCAAT
GCAGCGAATTACTTACACC -> CAGCGAATTACTTACACCG
GCAGCGCAGAATAACACGA -> CAGCGCAGAATAACACGAG
GCAGCTCCCGGGGTGCCTG -> CAGCTCCCGGGGTGCCTGG
GCAGGAATGAACAAATCTC -> CAGGAATGAACAAATCTCA
GCAGGAATGAACAATCGGT -> CAGGAATGAACAATCGGTT
GCAGGAATGAACATGGGGA -> CAGGAATGAACATGGGGAA
GCAGGAATGAACATTACTC -> CAGGAATGAACATTACTCT
GCAGGAGTGGAGGTTACAT -> CAGGAGTGGAGGTTACATT
GCAGGCCATATAACCGTTA -> CAGGCCATATAACCGTTAA
GCAGGTATCAGACAAGAAA -> CAGGTATCAGACAAGAAAA
GCATCAGCCCTTCTGTTGT -> CATCAGCCCTTCTGTTGTG
GCATGGGTGGAATTCGACT -> CATGGGTGGAATTCGACTG
GCATGGGTTATGATAGAGA -> CATGGGTTATGATAGAGAT
GCATTTATCCCGTAAGGTG -> CATTTATCCCGTAAGGTGG
GCCACTGCCATAGCCTGCT -> CCACTGCCATAGCCTGCTC
GCCAGCGGACGCCATCAGA -> CCAGCGGACGCCATCAGAA
GCCAGTTAGCCCGAGTAAT -> CCAGTTAGCCCGAGTAATA
GCCATAGCCTGCTCCCATG -> CCATAGCCTGCTCCCATGA
GCCATATAACCGTTAAATG -> CCATATAACCGTTAAATGT
GCCATCAGAAGATATTATA -> CCATCAGAAGATATTATAG
GCCATTTGGGTACCTCGAT -> CCATTTGGGTACCTCGATA
GCCCACCAAGCCCCGTTCG -> CCCACCAAGCCCCGTTCGT
GCCCAGCCATTTGGGTACC -> CCCAGCCATTTGGGTACCT
GCCCAGTACAACCTAACAG -> CCCAGTACAACCTAACAGA
GCCCCGATGCTTTCATGGA -> CCCCGATGCTTTCATGGAA
GCCCCGTTCGTTGAGTAAC -> CCCCGTTCGTTGAGTAACC
GCCCGAGTAATAGTACAGG -> CCCGAGTAATAGTACAGGT
GCCCGATGCCCTGTAATTA -> CCCGATGCCCTGTAATTAA
GCCCGCAGCTCCCGGGGTG -> CCCGCAGCTCCCGGGGTGC
GCCCGCTTGGTAATGCAGG -> CCCGCTTGGTAATGCAGGA
GCCCGGAAGCTCCCGGGGT -> CCCGGAAGCTCCCGGGGTG
GCCCTGTAATTAAGTCACA -> CCCTGTAATTAAGTCACAG
GCCCTTCTGTTGTGTGGTA -> CCCTTCTGTTGTGTGGTAG
GCCCTTGTTAATCGTCTCC -> CCCTTGTTAATCGTCTCCA
GCCGAATGTAATGTTCAGT -> CCGAATGTAATGTTCAGTA
GCCGGAATGCGAGACTTTA -> CCGGAATGCGAGACTTTAT
GCCGTGAGTGGGCCTAGCT -> CCGTGAGTGGGCCTAGCTC
GCCTAGCTCAGATTCCAGG -> CCTAGCTCAGATTCCAGGA
GCCTGACATAGTGGTAATG -> CCTGACATAGTGGTAATGC
GCCTGCTCCCATGATCCTC -> CCTGCTCCCATGATCCTCC
GCCTGGATGAAGGCGAAGG -> CCTGGATGAAGGCGAAGGT
GCCTGGCCTGACATAGTGG -> CCTGGCCTGACATAGTGGT
GCCTGGGGGTCAGGCGTGG -> CCTGGGGGTCAGGCGTGGT
GCCTGGTACGCCCGCTTGG -> CCTGGTACGCCCGCTTGGT
GCGAAGGTAATGCAGGAAT -> CGAAGGTAATGCAGGAATG
GCGAATTACTTACACCGCG -> CGAATTACTTACACCGCGT
GCGACATAAGGCGGTCATC -> CGACATAAGGCGGTCATCC
GCGACGTCACGTAGTGGAA -> CGACGTCACGTAGTGGAAG
GCGAGACTTTATATTTTGC -> CGAGACTTTATATTTTGCT
GCGAGAGAAGCGGTGTCGG -> CGAGAGAAGCGGTGTCGGC
GCGAGGGTATTCCATGGCT -> CGAGGGTATTCCATGGCTG
GCGAGGTTTAGGAAGTTAG -> CGAGGTTTAGGAAGTTAGT
GCGATCAACTTATAACGGA -> CGATCAACTTATAACGGAA
GCGATTTGTTACTTTCCGA -> CGATTTGTTACTTTCCGAG
GCGCAGAAAGTGCGACATA -> CGCAGAAAGTGCGACATAA
GCGCAGAATAACACGAGAC -> CGCAGAATAACACGAGACC
GCGCAGGTATCAGACAAGA -> CGCAGGTATCAGACAAGAA
GCGCCAGTTAGCCCGAGTA -> CGCCAGTTAGCCCGAGTAA
GCGCGCGCTAATAGCTCCC -> CGCGCGCTAATAGCTCCCG
GCGCGCTAATAGCTCCCGG -> CGCGCTAATAGCTCCCGGG
GCGCGGATCCAGGAGTGTG -> CGCGGATCCAGGAGTGTGA
GCGCGTTAAGTAGCTCTTT -> CGCGTTAAGTAGCTCTTTG
GCGCTAATAGCTCCCGGGG -> CGCTAATAGCTCCCGGGGT
GCGCTCAAAGCGCGTTAAG -> CGCTCAAAGCGCGTTAAGT
GCGGACATAAGTCGCGCTC -> CGGACATAAGTCGCGCTCA
GCGGACCTGTCGAGCTCCC -> CGGACCTGTCGAGCTCCCG
GCGGACGCCATCAGAAGAT -> CGGACGCCATCAGAAGATA
GCGGATCCAGGAGTGTGAT -> CGGATCCAGGAGTGTGATA
GCGGCAGACGCGGTTGTTC -> CGGCAGACGCGGTTGTTCC
GCGGCCCCGATGCTTTCAT -> CGGCCCCGATGCTTTCATG
GCGGCGCAGAAAGTGCGAC -> CGGCGCAGAAAGTGCGACA
GCGGCGTCGACCTCTTGTC -> CGGCGTCGACCTCTTGTCC
GCGGGATGACGTCGCAGCG -> CGGGATGACGTCGCAGCGA
GCGGTCATCCTAAACAGTT -> CGGTCATCCTAAACAGTTG
GCGGTCGCTCTGAGCAAAG -> CGGTCGCTCTGAGCAAAGG
GCGGTCTCGGTCTCAAGGG -> CGGTCTCGGTCTCAAGGGA
GCGGTGTCGGCACCAGACG -> CGGTGTCGGCACCAGACGG
GCGGTTGTTCCAATTGAGC -> CGGTTGTTCCAATTGAGCT
GCGGTTTGGTAAAATGTCT -> CGGTTTGGTAAAATGTCTC
GCGTACTGCGGCGTCGACC -> CGTACTGCGGCGTCGACCT
GCGTCATAAGAGGGAGCTA -> CGTCATAAGAGGGAGCTAT
GCGTCGACCTCTTGTCCTA -> CGTCGACCTCTTGTCCTAA
GCGTGACTTTGTCTCAACG -> CGTGACTTTGTCTCAACGG
GCGTGGTAATGCAGGAATG -> CGTGGTAATGCAGGAATGA
GCGTTAAGTAGCTCTTTGC -> CGTTAAGTAGCTCTTTGCA
GCGTTAATACGAGGGGAAG -> CGTTAATACGAGGGGAAGA
GCTAAATTCTTAACAGCGC -> CTAAATTCTTAACAGCGCG
GCTAAGCACTGTGTATCAC -> CTAAGCACTGTGTATCACA
GCTAATAGCTCCCGGGGTG -> CTAATAGCTCCCGGGGTGC
GCTATCCAGATGGGAAAAC -> CTATCCAGATGGGAAAACT
GCTCAAAGCGCGTTAAGTA -> CTCAAAGCGCGTTAAGTAG
GCTCACCTAACAATACCGT -> CTCACCTAACAATACCGTT
GCTCAGATTCCAGGATGAA -> CTCAGATTCCAGGATGAAT
GCTCATAATCCAGCGCCGC -> CTCATAATCCAGCGCCGCA
GCTCCAAGCAGGAGTGGAG -> CTCCAAGCAGGAGTGGAGG
GCTCCCATGATCCTCCAAA -> CTCCCATGATCCTCCAAAC
GCTCCCGGGGTGCCTGGAT -> CTCCCGGGGTGCCTGGATG
GCTCCCGGGGTGCCTGGCC -> CTCCCGGGGTGCCTGGCCT
GCTCCCGGGGTGCCTGGGG -> CTCCCGGGGTGCCTGGGGG
GCTCCCGGGGTGCCTGGTA -> CTCCCGGGGTGCCTGGTAC
GCTCCTATCCGTTATGGAT -> CTCCTATCCGTTATGGATA
GCTCCTCCTTGATGCGAGG -> CTCCTCCTTGATGCGAGGT
GCTCGTGTCAAGTCAGCGG -> CTCGTGTCAAGTCAGCGGC
GCTCTGAGCAAAGGGACCG -> CTCTGAGCAAAGGGACCGG
GCTCTTTGCACAAAATCAA -> CTCTTTGCACAAAATCAAT
GCTGCATGGGTTATGATAG -> CTGCATGGGTTATGATAGA
GCTGCGGCCCCGATGCTTT -> CTGCGGCCCCGATGCTTTC
GCTGGCATCAGCCCTTCTG -> CTGGCATCAGCCCTTCTGT
GCTGGTACTAGACGGCGTC -> CTGGTACTAGACGGCGTCA
GCTGGTTAACTTGTTGACG -> CTGGTTAACTTGTTGACGA
GCTGTATTTATATAACACT -> CTGTATTTATATAACACTT
GCTTAGCCGAATGTAATGT -> CTTAGCCGAATGTAATGTT
GCTTCTACCCGCTAAGCAC -> CTTCTACCCGCTAAGCACT
GCTTGCAACTGTCGCAAAT -> CTTGCAACTGTCGCAAATT
GCTTGGCGCAGGTATCAGA -> CTTGGCGCAGGTATCAGAC
GCTTGGTAATGCAGGAATG -> CTTGGTAATGCAGGAATGA
GCTTGTGTTTGGGGTCCGA -> CTTGTGTTTGGGGTCCGAT
GCTTTCATGGAATGATAAT -> CTTTCATGGAATGATAATA
GGAAAACTATTCATCCAGG -> GAAAACTATTCATCCAGGT
GGAACCAACCGGACTGGGG -> GAACCAACCGGACTGGGGC
GGAACGCGCGCGCTAATAG -> GAACGCGCGCGCTAATAGC
GGAACTGGGGGAACCAACC -> GAACTGGGGGAACCAACCG
GGAAGATGAAGATAGTATT -> GAAGATGAAGATAGTATTT
GGAAGCTCCCGGGGTGCCT -> GAAGCTCCCGGGGTGCCTG
GGAAGGCGGACATAAGTCG -> GAAGGCGGACATAAGTCGC
GGAAGTAACTGAGATACAG -> GAAGTAACTGAGATACAGA
GGAAGTTAGTGAGAGTGCT -> GAAGTTAGTGAGAGTGCTG
GGAATAGAAAAATCTTCAC -> GAATAGAAAAATCTTCACA
GGAATAGCCCAGTACAACC -> GAATAGCCCAGTACAACCT
GGAATGAACAAATCTCATT -> GAATGAACAAATCTCATTT
GGAATGAACAATCGGTTGA -> GAATGAACAATCGGTTGAC
GGAATGAACATGGGGAAGT -> GAATGAACATGGGGAAGTA
GGAATGAACATTACTCTTA -> GAATGAACATTACTCTTAG
GGAATGATAATATCCGGGG -> GAATGATAATATCCGGGGC
GGAATGCGAGACTTTATAT -> GAATGCGAGACTTTATATT
GGAATTCGACTGGGAATAG -> GAATTCGACTGGGAATAGA
GGACATAAGTCGCGCTCAA -> GACATAAGTCGCGCTCAAA
GGACATCCGTGCACCACCA -> GACATCCGTGCACCACCAG
GGACCGGGATAGGACATCC -> GACCGGGATAGGACATCCG
GGACCTGTCGAGCTCCCGG -> GACCTGTCGAGCTCCCGGG
GGACGCCATCAGAAGATAT -> GACGCCATCAGAAGATATT
GGACTGGGGCTCCTCCTTG -> GACTGGGGCTCCTCCTTGA
GGAGCACTGAAGCAATGCT -> GAGCACTGAAGCAATGCTT
GGAGCTATCCAGATGGGAA -> GAGCTATCCAGATGGGAAA
GGAGGTGAGAGAAATAATC -> GAGGTGAGAGAAATAATCC
GGAGGTTACATTCCTTGGT -> GAGGTTACATTCCTTGGTT
GGAGTGGAGGTTACATTCC -> GAGTGGAGGTTACATTCCT
GGAGTGTGATATCACCTTA -> GAGTGTGATATCACCTTAA
GGATACTGTGCTGGTACTA -> GATACTGTGCTGGTACTAG
GGATAGGACATCCGTGCAC -> GATAGGACATCCGTGCACC
GGATATCTCATGTAACAGT -> GATATCTCATGTAACAGTG
GGATCCAGGAGTGTGATAT -> GATCCAGGAGTGTGATATC
GGATCGATCCTGAGGGCGA -> GATCGATCCTGAGGGCGAC
GGATGAAGGCGAAGGTAAT -> GATGAAGGCGAAGGTAATG
GGATGAATACGGTAAGATG -> GATGAATACGGTAAGATGG
GGATGACGTCGCAGCGAAT -> GATGACGTCGCAGCGAATT
GGATGTAGCTCGTGTCAAG -> GATGTAGCTCGTGTCAAGT
GGATTATACCACTTATAGT -> GATTATACCACTTATAGTA
GGCACCAGACGGCTGCATG -> GCACCAGACGGCTGCATGG
GGCACTAAATCCCGTAATG -> GCACTAAATCCCGTAATGC
GGCAGACGCGGTTGTTCCA -> GCAGACGCGGTTGTTCCAA
GGCATCAGCCCTTCTGTTG -> GCATCAGCCCTTCTGTTGT
GGCATTTATCCCGTAAGGT -> GCATTTATCCCGTAAGGTG
GGCCACTGCCATAGCCTGC -> GCCACTGCCATAGCCTGCT
GGCCATATAACCGTTAAAT -> GCCATATAACCGTTAAATG
GGCCCCGATGCTTTCATGG -> GCCCCGATGCTTTCATGGA
GGCCGGAATGCGAGACTTT -> GCCGGAATGCGAGACTTTA
GGCCGTGAGTGGGCCTAGC -> GCCGTGAGTGGGCCTAGCT
GGCCTAGCTCAGATTCCAG -> GCCTAGCTCAGATTCCAGG
GGCCTGACATAGTGGTAAT -> GCCTGACATAGTGGTAATG
GGCGAAGGTAATGCAGGAA -> GCGAAGGTAATGCAGGAAT
GGCGACGTCACGTAGTGGA -> GCGACGTCACGTAGTGGAA
GGCGATTTGTTACTTTCCG -> GCGATTTGTTACTTTCCGA
GGCGCAGAAAGTGCGACAT -> GCGCAGAAAGTGCGACATA
GGCGCAGGTATCAGACAAG -> GCGCAGGTATCAGACAAGA
GGCGCCAGTTAGCCCGAGT -> GCGCCAGTTAGCCCGAGTA
GGCGGACATAAGTCGCGCT -> GCGGACATAAGTCGCGCTC
GGCGGCGCAGAAAGTGCGA -> GCGGCGCAGAAAGTGCGAC
GGCGGGATGACGTCGCAGC -> GCGGGATGACGTCGCAGCG
GGCGGTCATCCTAAACAGT -> GCGGTCATCCTAAACAGTT
GGCGGTCTCGGTCTCAAGG -> GCGGTCTCGGTCTCAAGGG
GGCGTACTGCGGCGTCGAC -> GCGTACTGCGGCGTCGACC
GGCGTCATAAGAGGGAGCT -> GCGTCATAAGAGGGAGCTA
GGCGTCGACCTCTTGTCCT -> GCGTCGACCTCTTGTCCTA
GGCGTGACTTTGTCTCAAC -> GCGTGACTTTGTCTCAACG
GGCGTGGTAATGCAGGAAT -> GCGTGGTAATGCAGGAATG
GGCTCACCTAACAATACCG -> GCTCACCTAACAATACCGT
GGCTCCTCCTTGATGCGAG -> GCTCCTCCTTGATGCGAGG
GGCTGCATGGGTTATGATA -> GCTGCATGGGTTATGATAG
GGCTGCGGCCCCGATGCTT -> GCTGCGGCCCCGATGCTTT
GGCTGGCATCAGCCCTTCT -> GCTGGCATCAGCCCTTCTG
GGGAAAACTATTCATCCAG -> GGAAAACTATTCATCCAGG
GGGAACCAACCGGACTGGG -> GGAACCAACCGGACTGGGG
GGGAAGATGAAGATAGTAT -> GGAAGATGAAGATAGTATT
GGGAAGTAACTGAGATACA -> GGAAGTAACTGAGATACAG
GGGAATAGAAAAATCTTCA -> GGAATAGAAAAATCTTCAC
GGGAATAGCCCAGTACAAC -> GGAATAGCCCAGTACAACC
GGGACCGGGATAGGACATC -> GGACCGGGATAGGACATCC
GGGAGCTATCCAGATGGGA -> GGAGCTATCCAGATGGGAA
GGGATAGGACATCCGTGCA -> GGATAGGACATCCGTGCAC
GGGATGACGTCGCAGCGAA -> GGATGACGTCGCAGCGAAT
GGGATTATACCACTTATAG -> GGATTATACCACTTATAGT
GGGCCGGAATGCGAGACTT -> GGCCGGAATGCGAGACTTT
GGGCCTAGCTCAGATTCCA -> GGCCTAGCTCAGATTCCAG
GGGCGACGTCACGTAGTGG -> GGCGACGTCACGTAGTGGA
GGGCGCCAGTTAGCCCGAG -> GGCGCCAGTTAGCCCGAGT
GGGCGTACTGCGGCGTCGA -> GGCGTACTGCGGCGTCGAC
GGGCTCCTCCTTGATGCGA -> GGCTCCTCCTTGATGCGAG
GGGGAACCAACCGGACTGG -> GGGAACCAACCGGACTGGG
GGGGAAGATGAAGATAGTA -> GGGAAGATGAAGATAGTAT
GGGGAAGTAACTGAGATAC -> GGGAAGTAACTGAGATACA
GGGGAATAGCCCAGTACAA -> GGGAATAGCCCAGTACAAC
GGGGCGTACTGCGGCGTCG -> GGGCGTACTGCGGCGTCGA
GGGGCTCCTCCTTGATGCG -> GGGCTCCTCCTTGATGCGA
GGGGGAACCAACCGGACTG -> GGGGAACCAACCGGACTGG
GGGGGTCAGGCGTGGTAAT -> GGGGTCAGGCGTGGTAATG
GGGGTCAGGCGTGGTAATG -> GGGTCAGGCGTGGTAATGC
GGGGTCCGATGACAAAGCC -> GGGTCCGATGACAAAGCCC
GGGGTGCCTGGATGAAGGC -> GGGTGCCTGGATGAAGGCG
GGGGTGCCTGGCCTGACAT -> GGGTGCCTGGCCTGACATA
GGGGTGCCTGGGGGTCAGG -> GGGTGCCTGGGGGTCAGGC
GGGGTGCCTGGTACGCCCG -> GGGTGCCTGGTACGCCCGC
GGGTACCTCGATATGAGGT -> GGTACCTCGATATGAGGTC
GGGTATTCCATGGCTGCGG -> GGTATTCCATGGCTGCGGC
GGGTCAGGCGTGGTAATGC -> GGTCAGGCGTGGTAATGCA
GGGTCATTGCGGACCTGTC -> GGTCATTGCGGACCTGTCG
GGGTCCGATGACAAAGCCC -> GGTCCGATGACAAAGCCCA
GGGTGCAATACCCAGGCTC -> GGTGCAATACCCAGGCTCA
GGGTGCCTGGATGAAGGCG -> GGTGCCTGGATGAAGGCGA
GGGTGCCTGGCCTGACATA -> GGTGCCTGGCCTGACATAG
GGGTGCCTGGGGGTCAGGC -> GGTGCCTGGGGGTCAGGCG
GGGTGCCTGGTACGCCCGC -> GGTGCCTGGTACGCCCGCT
GGGTGGAATTCGACTGGGA -> GGTGGAATTCGACTGGGAA
GGGTGTTCGCCCGCAGCTC -> GGTGTTCGCCCGCAGCTCC
GGGTTATGATAGAGATGCT -> GGTTATGATAGAGATGCTT
GGTAAAATGTCTCAGCGAG -> GTAAAATGTCTCAGCGAGG
GGTAAGATGGGCCGGAATG -> GTAAGATGGGCCGGAATGC
GGTAATGCAGGAATGAACA -> GTAATGCAGGAATGAACAA,GTAATGCAGGAATGAACAA,GTAATGCAGGAATGAACAT,GTAATGCAGGAATGAACAT
GGTAATTATAGGGTCATTG -> GTAATTATAGGGTCATTGC
GGTACCTCGATATGAGGTC -> GTACCTCGATATGAGGTCC
GGTACGCCCGCTTGGTAAT -> GTACGCCCGCTTGGTAATG
GGTACTAGACGGCGTCATA -> GTACTAGACGGCGTCATAA
GGTACTGGTTTAGGCGATT -> GTACTGGTTTAGGCGATTT
GGTAGGCATTTATCCCGTA -> GTAGGCATTTATCCCGTAA
GGTATCAGACAAGAAAAGC -> GTATCAGACAAGAAAAGCT
GGTATCTTCATAAGGTCCG -> GTATCTTCATAAGGTCCGC
GGTATGTCAGCTGTATTTA -> GTATGTCAGCTGTATTTAT
GGTATTCCATGGCTGCGGC -> GTATTCCATGGCTGCGGCC
GGTATTCTTTGGCGGGATG -> GTATTCTTTGGCGGGATGA
GGTCAGGCGTGGTAATGCA -> GTCAGGCGTGGTAATGCAG
GGTCATCCTAAACAGTTGC -> GTCATCCTAAACAGTTGCC
GGTCATTGCGGACCTGTCG -> GTCATTGCGGACCTGTCGA
GGTCCGATGACAAAGCCCA -> GTCCGATGACAAAGCCCAG
GGTCCGCCCGATGCCCTGT -> GTCCGCCCGATGCCCTGTA
GGTCCTGCAGCGCAGAATA -> GTCCTGCAGCGCAGAATAA
GGTCCTTCGATAGGCCGTG -> GTCCTTCGATAGGCCGTGA
GGTCGCTCTGAGCAAAGGG -> GTCGCTCTGAGCAAAGGGA
GGTCGTAGGCCACTGCCAT -> GTCGTAGGCCACTGCCATA
GGTCTCAAGGGATTATACC -> GTCTCAAGGGATTATACCA
GGTCTCGGTCTCAAGGGAT -> GTCTCGGTCTCAAGGGATT
GGTCTTCTACAAAGGAACG -> GTCTTCTACAAAGGAACGC
GGTGAGAGAAATAATCCAC -> GTGAGAGAAATAATCCACA
GGTGCAATACCCAGGCTCA -> GTGCAATACCCAGGCTCAC
GGTGCCTGGATGAAGGCGA -> GTGCCTGGATGAAGGCGAA
GGTGCCTGGCCTGACATAG -> GTGCCTGGCCTGACATAGT
GGTGCCTGGGGGTCAGGCG -> GTGCCTGGGGGTCAGGCGT
GGTGCCTGGTACGCCCGCT -> GTGCCTGGTACGCCCGCTT
GGTGGAATTCGACTGGGAA -> GTGGAATTCGACTGGGAAT
GGTGGTCGTAGGCCACTGC -> GTGGTCGTAGGCCACTGCC
GGTGTCGGCACCAGACGGC -> GTGTCGGCACCAGACGGCT
GGTGTTCGCCCGCAGCTCC -> GTGTTCGCCCGCAGCTCCC
GGTTAACTTGTTGACGACT -> GTTAACTTGTTGACGACTT
GGTTACATTCCTTGGTTCG -> GTTACATTCCTTGGTTCGT
GGTTATGATAGAGATGCTT -> GTTATGATAGAGATGCTTA
GGTTCGTTTAATAGAGGTA -> GTTCGTTTAATAGAGGTAC
GGTTGACCTCTAAACGACA -> GTTGACCTCTAAACGACAA
GGTTGTTCCAATTGAGCTT -> GTTGTTCCAATTGAGCTTC
GGTTTAGGAAGTTAGTGAG -> GTTTAGGAAGTTAGTGAGA
GGTTTAGGCGATTTGTTAC -> GTTTAGGCGATTTGTTACT
GGTTTGGTAAAATGTCTCA -> GTTTGGTAAAATGTCTCAG
GTAAAATGTCTCAGCGAGG -> TAAAATGTCTCAGCGAGGG
GTAACAGTGGTATGTCAGC -> TAACAGTGGTATGTCAGCT
GTAACCGGTAATTATAGGG -> TAACCGGTAATTATAGGGT
GTAACTGAGATACAGATAC -> TAACTGAGATACAGATACC
GTAAGATGGGCCGGAATGC -> TAAGATGGGCCGGAATGCG
GTAAGGTGGTCGTAGGCCA -> TAAGGTGGTCGTAGGCCAC
GTAATAGTACAGGTCTTCT -> TAATAGTACAGGTCTTCTA
GTAATGCAGGAATGAACAA -> TAATGCAGGAATGAACAAA,TAATGCAGGAATGAACAAT
GTAATGCAGGAATGAACAT -> TAATGCAGGAATGAACATG,TAATGCAGGAATGAACATT
GTAATGCTAAATTCTTAAC -> TAATGCTAAATTCTTAACA
GTAATGTTCAGTATAAGTT -> TAATGTTCAGTATAAGTTT
GTAATTAAGTCACAGAGCC -> TAATTAAGTCACAGAGCCC
GTAATTATAGGGTCATTGC -> TAATTATAGGGTCATTGCG
GTACAACCTAACAGAGAAC -> TACAACCTAACAGAGAACA
GTACAGGTCTTCTACAAAG -> TACAGGTCTTCTACAAAGG
GTACCTCGATATGAGGTCC -> TACCTCGATATGAGGTCCT
GTACGCCCGCTTGGTAATG -> TACGCCCGCTTGGTAATGC
GTACTAGACGGCGTCATAA -> TACTAGACGGCGTCATAAG
GTACTGCGGCGTCGACCTC -> TACTGCGGCGTCGACCTCT
GTACTGCGGTCGCTCTGAG -> TACTGCGGTCGCTCTGAGC
GTACTGGTTTAGGCGATTT -> TACTGGTTTAGGCGATTTG
GTAGATCATCGGATCGATC -> TAGATCATCGGATCGATCC
GTAGCGGTTTGGTAAAATG -> TAGCGGTTTGGTAAAATGT
GTAGCTCGTGTCAAGTCAG -> TAGCTCGTGTCAAGTCAGC
GTAGCTCTTTGCACAAAAT -> TAGCTCTTTGCACAAAATC
GTAGGCATTTATCCCGTAA -> TAGGCATTTATCCCGTAAG
GTAGGCCACTGCCATAGCC -> TAGGCCACTGCCATAGCCT
GTAGTATCACAAGTAGATC -> TAGTATCACAAGTAGATCA
GTAGTGGAAGGCGGACATA -> TAGTGGAAGGCGGACATAA
GTATAAGTTTATGCTTGTG -> TATAAGTTTATGCTTGTGT
GTATCACAAGTAGATCATC -> TATCACAAGTAGATCATCG
GTATCACATGTGGGGAATA -> TATCACATGTGGGGAATAG
GTATCAGACAAGAAAAGCT -> TATCAGACAAGAAAAGCTT
GTATCTTCATAAGGTCCGC -> TATCTTCATAAGGTCCGCC
GTATGTCAGCTGTATTTAT -> TATGTCAGCTGTATTTATA
GTATTCCATGGCTGCGGCC -> TATTCCATGGCTGCGGCCC
GTATTCTTTGGCGGGATGA -> TATTCTTTGGCGGGATGAC
GTATTTATATAACACTTGG -> TATTTATATAACACTTGGA
GTATTTGCCCGGAAGCTCC -> TATTTGCCCGGAAGCTCCC
GTCAAGTCAGCGGCAGACG -> TCAAGTCAGCGGCAGACGC
GTCACAGAGCCCACCAAGC -> TCACAGAGCCCACCAAGCC
GTCACGTAGTGGAAGGCGG -> TCACGTAGTGGAAGGCGGA
GTCAGCGGCAGACGCGGTT -> TCAGCGGCAGACGCGGTTG
GTCAGCTGTATTTATATAA -> TCAGCTGTATTTATATAAC
GTCAGGCGTGGTAATGCAG -> TCAGGCGTGGTAATGCAGG
GTCATAAGAGGGAGCTATC -> TCATAAGAGGGAGCTATCC
GTCATAGACCTCAAAGTCT -> TCATAGACCTCAAAGTCTT
GTCATCCTAAACAGTTGCC -> TCATCCTAAACAGTTGCCC
GTCATTGCGGACCTGTCGA -> TCATTGCGGACCTGTCGAG
GTCCCGAAATACGACCATT -> TCCCGAAATACGACCATTT
GTCCGATGACAAAGCCCAG -> TCCGATGACAAAGCCCAGC
GTCCGCCCGATGCCCTGTA -> TCCGCCCGATGCCCTGTAA
GTCCTAAAATTATTCCAGG -> TCCTAAAATTATTCCAGGC
GTCCTGCAGCGCAGAATAA -> TCCTGCAGCGCAGAATAAC
GTCCTTCGATAGGCCGTGA -> TCCTTCGATAGGCCGTGAG
GTCCTTCTGGCGTGACTTT -> TCCTTCTGGCGTGACTTTG
GTCGACCTCTTGTCCTAAA -> TCGACCTCTTGTCCTAAAA
GTCGAGCTCCCGGGGTGCC -> TCGAGCTCCCGGGGTGCCT
GTCGCAAATTTAGCGAGAG -> TCGCAAATTTAGCGAGAGA
GTCGCAGCGAATTACTTAC -> TCGCAGCGAATTACTTACA
GTCGCGCTCAAAGCGCGTT -> TCGCGCTCAAAGCGCGTTA
GTCGCTCTGAGCAAAGGGA -> TCGCTCTGAGCAAAGGGAC
GTCGGCACCAGACGGCTGC -> TCGGCACCAGACGGCTGCA
GTCGGGTGTTCGCCCGCAG -> TCGGGTGTTCGCCCGCAGC
GTCGTAGGCCACTGCCATA -> TCGTAGGCCACTGCCATAG
GTCTCAACGGCACTAAATC -> TCTCAACGGCACTAAATCC
GTCTCAAGGGATTATACCA -> TCTCAAGGGATTATACCAC
GTCTCAGCGAGGGTATTCC -> TCTCAGCGAGGGTATTCCA
GTCTCCAGACGTAGCGGTT -> TCTCCAGACGTAGCGGTTT
GTCTCGGTCTCAAGGGATT -> TCTCGGTCTCAAGGGATTA
GTCTTCCATATTGTCCTTC -> TCTTCCATATTGTCCTTCT
GTCTTCTACAAAGGAACGC -> TCTTCTACAAAGGAACGCG
GTGAACCTACGCGATCAAC -> TGAACCTACGCGATCAACT
GTGACTTTGTCTCAACGGC -> TGACTTTGTCTCAACGGCA
GTGAGACCCCGGGTGCAAT -> TGAGACCCCGGGTGCAATA
GTGAGAGAAATAATCCACA -> TGAGAGAAATAATCCACAA
GTGAGAGTCATAGACCTCA -> TGAGAGTCATAGACCTCAA
GTGAGAGTGCTGGTTAACT -> TGAGAGTGCTGGTTAACTT
GTGAGTGGGCCTAGCTCAG -> TGAGTGGGCCTAGCTCAGA
GTGATATCACCTTAACATG -> TGATATCACCTTAACATGC
GTGCAATACCCAGGCTCAC -> TGCAATACCCAGGCTCACC
GTGCACCACCAGTGAGACC -> TGCACCACCAGTGAGACCC
GTGCCAGCGGACGCCATCA -> TGCCAGCGGACGCCATCAG
GTGCCTGGATGAAGGCGAA -> TGCCTGGATGAAGGCGAAG
GTGCCTGGCCTGACATAGT -> TGCCTGGCCTGACATAGTG
GTGCCTGGGGGTCAGGCGT -> TGCCTGGGGGTCAGGCGTG
GTGCCTGGTACGCCCGCTT -> TGCCTGGTACGCCCGCTTG
GTGCGACATAAGGCGGTCA -> TGCGACATAAGGCGGTCAT
GTGCTGGTACTAGACGGCG -> TGCTGGTACTAGACGGCGT
GTGCTGGTTAACTTGTTGA -> TGCTGGTTAACTTGTTGAC
GTGGAAGGCGGACATAAGT -> TGGAAGGCGGACATAAGTC
GTGGAATTCGACTGGGAAT -> TGGAATTCGACTGGGAATA
GTGGAGGTTACATTCCTTG -> TGGAGGTTACATTCCTTGG
GTGGCTGGCATCAGCCCTT -> TGGCTGGCATCAGCCCTTC
GTGGGCCTAGCTCAGATTC -> TGGGCCTAGCTCAGATTCC
GTGGGGAATAGCCCAGTAC -> TGGGGAATAGCCCAGTACA
GTGGTAATGCAGGAATGAA -> TGGTAATGCAGGAATGAAC,TGGTAATGCAGGAATGAAC
GTGGTAGGCATTTATCCCG -> TGGTAGGCATTTATCCCGT
GTGGTATGTCAGCTGTATT -> TGGTATGTCAGCTGTATTT
GTGGTCGTAGGCCACTGCC -> TGGTCGTAGGCCACTGCCA
GTGTATCACATGTGGGGAA -> TGTATCACATGTGGGGAAT
GTGTCAAGTCAGCGGCAGA -> TGTCAAGTCAGCGGCAGAC
GTGTCGGCACCAGACGGCT -> TGTCGGCACCAGACGGCTG
GTGTGATATCACCTTAACA -> TGTGATATCACCTTAACAT
GTGTGGTAGGCATTTATCC -> TGTGGTAGGCATTTATCCC
GTGTTCGCCCGCAGCTCCC -> TGTTCGCCCGCAGCTCCCG
GTGTTTGGGGTCCGATGAC -> TGTTTGGGGTCCGATGACA
GTTAAATGTGGCTGGCATC -> TTAAATGTGGCTGGCATCA
GTTAACTTGTTGACGACTT -> TTAACTTGTTGACGACTTT
GTTAAGTAGCTCTTTGCAC -> TTAAGTAGCTCTTTGCACA
GTTAATACGAGGGGAAGAT -> TTAATACGAGGGGAAGATG
GTTAATCGTCTCCAGACGT -> TTAATCGTCTCCAGACGTA
GTTACATTCCTTGGTTCGT -> TTACATTCCTTGGTTCGTT
GTTACTTTCCGAGTTATTA -> TTACTTTCCGAGTTATTAC
GTTAGCCCGAGTAATAGTA -> TTAGCCCGAGTAATAGTAC
GTTAGTGAGAGTGCTGGTT -> TTAGTGAGAGTGCTGGTTA
GTTATGATAGAGATGCTTA -> TTATGATAGAGATGCTTAG
GTTATGGATATCTCATGTA -> TTATGGATATCTCATGTAA
GTTATTACGCATGGGTGGA -> TTATTACGCATGGGTGGAA
GTTCAGAGGGCGCCAGTTA -> TTCAGAGGGCGCCAGTTAG
GTTCAGTATAAGTTTATGC -> TTCAGTATAAGTTTATGCT
GTTCCAATTGAGCTTCTAC -> TTCCAATTGAGCTTCTACC
GTTCGCCCGCAGCTCCCGG -> TTCGCCCGCAGCTCCCGGG
GTTCGTTGAGTAACCGGTA -> TTCGTTGAGTAACCGGTAA
GTTCGTTGTGAGAGTCATA -> TTCGTTGTGAGAGTCATAG
GTTCGTTTAATAGAGGTAC -> TTCGTTTAATAGAGGTACT
GTTGACCTCTAAACGACAA -> TTGACCTCTAAACGACAAA
GTTGACGACTTTCGAATAG -> TTGACGACTTTCGAATAGT
GTTGAGTAACCGGTAATTA -> TTGAGTAACCGGTAATTAT
GTTGCCCTTGTTAATCGTC -> TTGCCCTTGTTAATCGTCT
GTTGGATGTAGCTCGTGTC -> TTGGATGTAGCTCGTGTCA
GTTGTGAGAGTCATAGACC -> TTGTGAGAGTCATAGACCT
GTTGTGTGGTAGGCATTTA -> TTGTGTGGTAGGCATTTAT
GTTGTTCCAATTGAGCTTC -> TTGTTCCAATTGAGCTTCT
GTTTAATAGAGGTACTGGT -> TTTAATAGAGGTACTGGTT
GTTTAGGAAGTTAGTGAGA -> TTTAGGAAGTTAGTGAGAG
GTTTAGGCGATTTGTTACT -> TTTAGGCGATTTGTTACTT
GTTTATGCTTGTGTTTGGG -> TTTATGCTTGTGTTTGGGG
GTTTGGGGTCCGATGACAA -> TTTGGGGTCCGATGACAAA
GTTTGGTAAAATGTCTCAG -> TTTGGTAAAATGTCTCAGC
TAAAATGTCTCAGCGAGGG -> AAAATGTCTCAGCGAGGGT
TAAAATTATTCCAGGCGGT -> AAAATTATTCCAGGCGGTC
TAAACAGTTGCCCTTGTTA -> AAACAGTTGCCCTTGTTAA
TAAACATTGTGAACCTACG -> AAACATTGTGAACCTACGC
TAAACGACAAAGCTCCAAG -> AAACGACAAAGCTCCAAGC
TAAATCCCGTAATGCTAAA -> AAATCCCGTAATGCTAAAT
TAAATGTGGCTGGCATCAG -> AAATGTGGCTGGCATCAGC
TAAATTCTTAACAGCGCGG -> AAATTCTTAACAGCGCGGA
TAACAATACCGTTCGTTGT -> AACAATACCGTTCGTTGTG
TAACACGAGACCAATCGTT -> AACACGAGACCAATCGTTG
TAACACTTGGAGGTGAGAG -> AACACTTGGAGGTGAGAGA
TAACAGAGAACAAAGCTCC -> AACAGAGAACAAAGCTCCT
TAACAGCGCGGATCCAGGA -> AACAGCGCGGATCCAGGAG
TAACAGTGGTATGTCAGCT -> AACAGTGGTATGTCAGCTG
TAACATGCAGGCCATATAA -> AACATGCAGGCCATATAAC
TAACCGGTAATTATAGGGT -> AACCGGTAATTATAGGGTC
TAACCGTTAAATGTGGCTG -> AACCGTTAAATGTGGCTGG
TAACGGAACTGGGGGAACC -> AACGGAACTGGGGGAACCA
TAACTAGGCGGCGCAGAAA -> AACTAGGCGGCGCAGAAAG
TAACTGAGATACAGATACC -> AACTGAGATACAGATACCT
TAACTTGTTGACGACTTTC -> AACTTGTTGACGACTTTCG
TAAGAGGGAGCTATCCAGA -> AAGAGGGAGCTATCCAGAT
TAAGATGGGCCGGAATGCG -> AAGATGGGCCGGAATGCGA
TAAGCACTGTGTATCACAT -> AAGCACTGTGTATCACATG
TAAGGCGGTCATCCTAAAC -> AAGGCGGTCATCCTAAACA
TAAGGTCCGCCCGATGCCC -> AAGGTCCGCCCGATGCCCT
TAAGGTGGTCGTAGGCCAC -> AAGGTGGTCGTAGGCCACT
TAAGTAGCTCTTTGCACAA -> AAGTAGCTCTTTGCACAAA
TAAGTCACAGAGCCCACCA -> AAGTCACAGAGCCCACCAA
TAAGTCGCGCTCAAAGCGC -> AAGTCGCGCTCAAAGCGCG
TAAGTTTATGCTTGTGTTT -> AAGTTTATGCTTGTGTTTG
TAATACGAGGGGAAGATGA -> AATACGAGGGGAAGATGAA
TAATAGAGGTACTGGTTTA -> AATAGAGGTACTGGTTTAG
TAATAGCTCCCGGGGTGCC -> AATAGCTCCCGGGGTGCCT
TAATAGTACAGGTCTTCTA -> AATAGTACAGGTCTTCTAC
TAATATCCGGGGCGTACTG -> AATATCCGGGGCGTACTGC
TAATCCACAAAGTCGGGTG -> AATCCACAAAGTCGGGTGT
TAATCGCAATAGGTATCTT -> AATCGCAATAGGTATCTTC
TAATCGTCTCCAGACGTAG -> AATCGTCTCCAGACGTAGC
TAATGCAGGAATGAACAAA -> AATGCAGGAATGAACAAAT
TAATGCAGGAATGAACAAT -> AATGCAGGAATGAACAATC
TAATGCAGGAATGAACATG -> AATGCAGGAATGAACATGG
TAATGCAGGAATGAACATT -> AATGCAGGAATGAACATTA
TAATGCTAAATTCTTAACA -> AATGCTAAATTCTTAACAG
TAATGTTCAGTATAAGTTT -> AATGTTCAGTATAAGTTTA
TAATTAAGTCACAGAGCCC -> AATTAAGTCACAGAGCCCA
TAATTATAGGGTCATTGCG -> AATTATAGGGTCATTGCGG
TACAAAGGAACGCGCGCGC -> ACAAAGGAACGCGCGCGCT
TACAACCTAACAGAGAACA -> ACAACCTAACAGAGAACAA
TACACCGCGTTAATACGAG -> ACACCGCGTTAATACGAGG
TACAGATACCTGGATACTG -> ACAGATACCTGGATACTGT
TACAGGTCTTCTACAAAGG -> ACAGGTCTTCTACAAAGGA
TACATTCCTTGGTTCGTTT -> ACATTCCTTGGTTCGTTTA
TACCACTTATAGTACTGCG -> ACCACTTATAGTACTGCGG
TACCCAGGCTCACCTAACA -> ACCCAGGCTCACCTAACAA
TACCCGCTAAGCACTGTGT -> ACCCGCTAAGCACTGTGTA
TACCGTTCGTTGTGAGAGT -> ACCGTTCGTTGTGAGAGTC
TACCTCGATATGAGGTCCT -> ACCTCGATATGAGGTCCTT
TACCTGGATACTGTGCTGG -> ACCTGGATACTGTGCTGGT
TACGACCATTTCCACCTAA -> ACGACCATTTCCACCTAAT
TACGAGGGGAAGATGAAGA -> ACGAGGGGAAGATGAAGAT
TACGCATGGGTGGAATTCG -> ACGCATGGGTGGAATTCGA
TACGCCCGCTTGGTAATGC -> ACGCCCGCTTGGTAATGCA
TACGCGATCAACTTATAAC -> ACGCGATCAACTTATAACG
TACGGTAAGATGGGCCGGA -> ACGGTAAGATGGGCCGGAA
TACTAGACGGCGTCATAAG -> ACTAGACGGCGTCATAAGA
TACTCTTAGAGACTATGTA -> ACTCTTAGAGACTATGTAG
TACTGCGGCGTCGACCTCT -> ACTGCGGCGTCGACCTCTT
TACTGCGGTCGCTCTGAGC -> ACTGCGGTCGCTCTGAGCA
TACTGGTTTAGGCGATTTG -> ACTGGTTTAGGCGATTTGT
TACTGTGCTGGTACTAGAC -> ACTGTGCTGGTACTAGACG
TACTTACACCGCGTTAATA -> ACTTACACCGCGTTAATAC
TACTTTCCGAGTTATTACG -> ACTTTCCGAGTTATTACGC
TAGAAAAATCTTCACACGA -> AGAAAAATCTTCACACGAT
TAGACCTCAAAGTCTTCCA -> AGACCTCAAAGTCTTCCAT
TAGACGGCGTCATAAGAGG -> AGACGGCGTCATAAGAGGG
TAGAGACTATGTAGTATCA -> AGAGACTATGTAGTATCAC
TAGAGATGCTTAGCCGAAT -> AGAGATGCTTAGCCGAATG
TAGAGGTACTGGTTTAGGC -> AGAGGTACTGGTTTAGGCG
TAGATCATCGGATCGATCC -> AGATCATCGGATCGATCCT
TAGCCCAGTACAACCTAAC -> AGCCCAGTACAACCTAACA
TAGCCCGAGTAATAGTACA -> AGCCCGAGTAATAGTACAG
TAGCCGAATGTAATGTTCA -> AGCCGAATGTAATGTTCAG
TAGCCTGCTCCCATGATCC -> AGCCTGCTCCCATGATCCT
TAGCGAGAGAAGCGGTGTC -> AGCGAGAGAAGCGGTGTCG
TAGCGGTTTGGTAAAATGT -> AGCGGTTTGGTAAAATGTC
TAGCTCAGATTCCAGGATG -> AGCTCAGATTCCAGGATGA
TAGCTCCCGGGGTGCCTGG -> AGCTCCCGGGGTGCCTGGT
TAGCTCGTGTCAAGTCAGC -> AGCTCGTGTCAAGTCAGCG
TAGCTCTTTGCACAAAATC -> AGCTCTTTGCACAAAATCA
TAGGAAGTTAGTGAGAGTG -> AGGAAGTTAGTGAGAGTGC
TAGGACATCCGTGCACCAC -> AGGACATCCGTGCACCACC
TAGGCATTTATCCCGTAAG -> AGGCATTTATCCCGTAAGG
TAGGCCACTGCCATAGCCT -> AGGCCACTGCCATAGCCTG
TAGGCCGTGAGTGGGCCTA -> AGGCCGTGAGTGGGCCTAG
TAGGCGATTTGTTACTTTC -> AGGCGATTTGTTACTTTCC
TAGGCGGCGCAGAAAGTGC -> AGGCGGCGCAGAAAGTGCG
TAGGGTCATTGCGGACCTG -> AGGGTCATTGCGGACCTGT
TAGGTATCTTCATAAGGTC -> AGGTATCTTCATAAGGTCC
TAGGTATTCTTTGGCGGGA -> AGGTATTCTTTGGCGGGAT
TAGTACAGGTCTTCTACAA -> AGTACAGGTCTTCTACAAA
TAGTACTGCGGTCGCTCTG -> AGTACTGCGGTCGCTCTGA
TAGTATCACAAGTAGATCA -> AGTATCACAAGTAGATCAT
TAGTATTTGCCCGGAAGCT -> AGTATTTGCCCGGAAGCTC
TAGTCCCGAAATACGACCA -> AGTCCCGAAATACGACCAT
TAGTGAGAGTGCTGGTTAA -> AGTGAGAGTGCTGGTTAAC
TAGTGCCAGCGGACGCCAT -> AGTGCCAGCGGACGCCATC
TAGTGGAAGGCGGACATAA -> AGTGGAAGGCGGACATAAG
TAGTGGTAATGCAGGAATG -> AGTGGTAATGCAGGAATGA
TATAACACTTGGAGGTGAG -> ATAACACTTGGAGGTGAGA
TATAACCGTTAAATGTGGC -> ATAACCGTTAAATGTGGCT
TATAACGGAACTGGGGGAA -> ATAACGGAACTGGGGGAAC
TATAAGTTTATGCTTGTGT -> ATAAGTTTATGCTTGTGTT
TATACCACTTATAGTACTG -> ATACCACTTATAGTACTGC
TATAGGGTCATTGCGGACC -> ATAGGGTCATTGCGGACCT
TATAGGTATTCTTTGGCGG -> ATAGGTATTCTTTGGCGGG
TATAGTACTGCGGTCGCTC -> ATAGTACTGCGGTCGCTCT
TATATAACACTTGGAGGTG -> ATATAACACTTGGAGGTGA
TATATTTTGCTCATAATCC -> ATATTTTGCTCATAATCCA
TATCACAAGTAGATCATCG -> ATCACAAGTAGATCATCGG
TATCACATGTGGGGAATAG -> ATCACATGTGGGGAATAGC
TATCACCTTAACATGCAGG -> ATCACCTTAACATGCAGGC
TATCAGACAAGAAAAGCTT -> ATCAGACAAGAAAAGCTTG
TATCCAGATGGGAAAACTA -> ATCCAGATGGGAAAACTAT
TATCCCGTAAGGTGGTCGT -> ATCCCGTAAGGTGGTCGTA
TATCCGGGGCGTACTGCGG -> ATCCGGGGCGTACTGCGGC
TATCCGTTATGGATATCTC -> ATCCGTTATGGATATCTCA
TATCTCATGTAACAGTGGT -> ATCTCATGTAACAGTGGTA
TATCTTCATAAGGTCCGCC -> ATCTTCATAAGGTCCGCCC
TATGAGGTCCTTCGATAGG -> ATGAGGTCCTTCGATAGGC
TATGATAGAGATGCTTAGC -> ATGATAGAGATGCTTAGCC
TATGCTTGTGTTTGGGGTC -> ATGCTTGTGTTTGGGGTCC
TATGGATATCTCATGTAAC -> ATGGATATCTCATGTAACA
TATGTAGTATCACAAGTAG -> ATGTAGTATCACAAGTAGA
TATGTCAGCTGTATTTATA -> ATGTCAGCTGTATTTATAT
TATTACGCATGGGTGGAAT -> ATTACGCATGGGTGGAATT
TATTATAGGTATTCTTTGG -> ATTATAGGTATTCTTTGGC
TATTCATCCAGGTCCTGCA -> ATTCATCCAGGTCCTGCAG
TATTCCAGGCGGTCTCGGT -> ATTCCAGGCGGTCTCGGTC
TATTCCATGGCTGCGGCCC -> ATTCCATGGCTGCGGCCCC
TATTCTTTGGCGGGATGAC -> ATTCTTTGGCGGGATGACG
TATTGTCCTTCTGGCGTGA -> ATTGTCCTTCTGGCGTGAC
TATTTATATAACACTTGGA -> ATTTATATAACACTTGGAG
TATTTGCCCGGAAGCTCCC -> ATTTGCCCGGAAGCTCCCG
TATTTTGCTCATAATCCAG -> ATTTTGCTCATAATCCAGC
TCAAAGCGCGTTAAGTAGC -> CAAAGCGCGTTAAGTAGCT
TCAAAGTCTTCCATATTGT -> CAAAGTCTTCCATATTGTC
TCAACGGCACTAAATCCCG -> CAACGGCACTAAATCCCGT
TCAACTTATAACGGAACTG -> CAACTTATAACGGAACTGG
TCAAGGGATTATACCACTT -> CAAGGGATTATACCACTTA
TCAAGTCAGCGGCAGACGC -> CAAGTCAGCGGCAGACGCG
TCAATTCTGTTCAGAGGGC -> CAATTCTGTTCAGAGGGCG
TCACAAGTAGATCATCGGA -> CACAAGTAGATCATCGGAT
TCACACGATCACTAACTAG -> CACACGATCACTAACTAGG
TCACAGAGCCCACCAAGCC -> CACAGAGCCCACCAAGCCC
TCACATGTGGGGAATAGCC -> CACATGTGGGGAATAGCCC
TCACCTAACAATACCGTTC -> CACCTAACAATACCGTTCG
TCACCTTAACATGCAGGCC -> CACCTTAACATGCAGGCCA
TCACGTAGTGGAAGGCGGA -> CACGTAGTGGAAGGCGGAC
TCACTAACTAGGCGGCGCA -> CACTAACTAGGCGGCGCAG
TCAGAAGATATTATAGGTA -> CAGAAGATATTATAGGTAT
TCAGACAAGAAAAGCTTGC -> CAGACAAGAAAAGCTTGCA
TCAGAGGGCGCCAGTTAGC -> CAGAGGGCGCCAGTTAGCC
TCAGATTCCAGGATGAATA -> CAGATTCCAGGATGAATAC
TCAGCCCTTCTGTTGTGTG -> CAGCCCTTCTGTTGTGTGG
TCAGCGAGGGTATTCCATG -> CAGCGAGGGTATTCCATGG
TCAGCGGCAGACGCGGTTG -> CAGCGGCAGACGCGGTTGT
TCAGCTGTATTTATATAAC -> CAGCTGTATTTATATAACA
TCAGGCGTGGTAATGCAGG -> CAGGCGTGGTAATGCAGGA
TCAGTATAAGTTTATGCTT -> CAGTATAAGTTTATGCTTG
TCATAAGAGGGAGCTATCC -> CATAAGAGGGAGCTATCCA
TCATAAGGTCCGCCCGATG -> CATAAGGTCCGCCCGATGC
TCATAATCCAGCGCCGCAT -> CATAATCCAGCGCCGCATA
TCATAGACCTCAAAGTCTT -> CATAGACCTCAAAGTCTTC
TCATCCAGGTCCTGCAGCG -> CATCCAGGTCCTGCAGCGC
TCATCCTAAACAGTTGCCC -> CATCCTAAACAGTTGCCCT
TCATCGGATCGATCCTGAG -> CATCGGATCGATCCTGAGG
TCATGGAATGATAATATCC -> CATGGAATGATAATATCCG
TCATGTAACAGTGGTATGT -> CATGTAACAGTGGTATGTC
TCATTGCGGACCTGTCGAG -> CATTGCGGACCTGTCGAGC
TCATTTTTAAACATTGTGA -> CATTTTTAAACATTGTGAA
TCCAAACGGAGCACTGAAG -> CCAAACGGAGCACTGAAGC
TCCAAGCAGGAGTGGAGGT -> CCAAGCAGGAGTGGAGGTT
TCCAATTGAGCTTCTACCC -> CCAATTGAGCTTCTACCCG
TCCACAAAGTCGGGTGTTC -> CCACAAAGTCGGGTGTTCG
TCCACCTAATCGCAATAGG -> CCACCTAATCGCAATAGGT
TCCAGACGTAGCGGTTTGG -> CCAGACGTAGCGGTTTGGT
TCCAGATGGGAAAACTATT -> CCAGATGGGAAAACTATTC
TCCAGGAGTGTGATATCAC -> CCAGGAGTGTGATATCACC
TCCAGGATGAATACGGTAA -> CCAGGATGAATACGGTAAG
TCCAGGCGGTCTCGGTCTC -> CCAGGCGGTCTCGGTCTCA
TCCAGGTCCTGCAGCGCAG -> CCAGGTCCTGCAGCGCAGA
TCCATATTGTCCTTCTGGC -> CCATATTGTCCTTCTGGCG
TCCATGGCTGCGGCCCCGA -> CCATGGCTGCGGCCCCGAT
TCCCATGATCCTCCAAACG -> CCCATGATCCTCCAAACGG
TCCCGAAATACGACCATTT -> CCCGAAATACGACCATTTC
TCCCGGGGTGCCTGGATGA -> CCCGGGGTGCCTGGATGAA
TCCCGGGGTGCCTGGCCTG -> CCCGGGGTGCCTGGCCTGA
TCCCGGGGTGCCTGGGGGT -> CCCGGGGTGCCTGGGGGTC
TCCCGGGGTGCCTGGTACG -> CCCGGGGTGCCTGGTACGC
TCCCGTAAGGTGGTCGTAG -> CCCGTAAGGTGGTCGTAGG
TCCCGTAATGCTAAATTCT -> CCCGTAATGCTAAATTCTT
TCCGAGTTATTACGCATGG -> CCGAGTTATTACGCATGGG
TCCGATGACAAAGCCCAGC -> CCGATGACAAAGCCCAGCC
TCCGCCCGATGCCCTGTAA -> CCGCCCGATGCCCTGTAAT
TCCGGGGCGTACTGCGGCG -> CCGGGGCGTACTGCGGCGT
TCCGTGCACCACCAGTGAG -> CCGTGCACCACCAGTGAGA
TCCGTTATGGATATCTCAT -> CCGTTATGGATATCTCATG
TCCTAAAATTATTCCAGGC -> CCTAAAATTATTCCAGGCG
TCCTAAACAGTTGCCCTTG -> CCTAAACAGTTGCCCTTGT
TCCTATCCGTTATGGATAT -> CCTATCCGTTATGGATATC
TCCTCCAAACGGAGCACTG -> CCTCCAAACGGAGCACTGA
TCCTCCTTGATGCGAGGTT -> CCTCCTTGATGCGAGGTTT
TCCTGAGGGCGACGTCACG -> CCTGAGGGCGACGTCACGT
TCCTGCAGCGCAGAATAAC -> CCTGCAGCGCAGAATAACA
TCCTTCGATAGGCCGTGAG -> CCTTCGATAGGCCGTGAGT
TCCTTCTGGCGTGACTTTG -> CCTTCTGGCGTGACTTTGT
TCCTTGATGCGAGGTTTAG -> CCTTGATGCGAGGTTTAGG
TCCTTGGTTCGTTTAATAG -> CCTTGGTTCGTTTAATAGA
TCGAATAGTCCCGAAATAC -> CGAATAGTCCCGAAATACG
TCGACCTCTTGTCCTAAAA -> CGACCTCTTGTCCTAAAAT
TCGACTGGGAATAGAAAAA -> CGACTGGGAATAGAAAAAT
TCGAGCTCCCGGGGTGCCT -> CGAGCTCCCGGGGTGCCTG
TCGATAGGCCGTGAGTGGG -> CGATAGGCCGTGAGTGGGC
TCGATATGAGGTCCTTCGA -> CGATATGAGGTCCTTCGAT
TCGATCCTGAGGGCGACGT -> CGATCCTGAGGGCGACGTC
TCGCAAATTTAGCGAGAGA -> CGCAAATTTAGCGAGAGAA
TCGCAATAGGTATCTTCAT -> CGCAATAGGTATCTTCATA
TCGCAGCGAATTACTTACA -> CGCAGCGAATTACTTACAC
TCGCCCGCAGCTCCCGGGG -> CGCCCGCAGCTCCCGGGGT
TCGCGCTCAAAGCGCGTTA -> CGCGCTCAAAGCGCGTTAA
TCGCTCTGAGCAAAGGGAC -> CGCTCTGAGCAAAGGGACC
TCGGATCGATCCTGAGGGC -> CGGATCGATCCTGAGGGCG
TCGGCACCAGACGGCTGCA -> CGGCACCAGACGGCTGCAT
TCGGGTGTTCGCCCGCAGC -> CGGGTGTTCGCCCGCAGCT
TCGGTCTCAAGGGATTATA -> CGGTCTCAAGGGATTATAC
TCGGTTGACCTCTAAACGA -> CGGTTGACCTCTAAACGAC
TCGTAGGCCACTGCCATAG -> CGTAGGCCACTGCCATAGC
TCGTCTCCAGACGTAGCGG -> CGTCTCCAGACGTAGCGGT
TCGTGTCAAGTCAGCGGCA -> CGTGTCAAGTCAGCGGCAG
TCGTTGAGTAACCGGTAAT -> CGTTGAGTAACCGGTAATT
TCGTTGGATGTAGCTCGTG -> CGTTGGATGTAGCTCGTGT
TCGTTGTGAGAGTCATAGA -> CGTTGTGAGAGTCATAGAC
TCGTTTAATAGAGGTACTG -> CGTTTAATAGAGGTACTGG
TCTAAACGACAAAGCTCCA -> CTAAACGACAAAGCTCCAA
TCTACAAAGGAACGCGCGC -> CTACAAAGGAACGCGCGCG
TCTACCCGCTAAGCACTGT -> CTACCCGCTAAGCACTGTG
TCTCAACGGCACTAAATCC -> CTCAACGGCACTAAATCCC
TCTCAAGGGATTATACCAC -> CTCAAGGGATTATACCACT
TCTCAGCGAGGGTATTCCA -> CTCAGCGAGGGTATTCCAT
TCTCATGTAACAGTGGTAT -> CTCATGTAACAGTGGTATG
TCTCATTTTTAAACATTGT -> CTCATTTTTAAACATTGTG
TCTCCAGACGTAGCGGTTT -> CTCCAGACGTAGCGGTTTG
TCTCGGTCTCAAGGGATTA -> CTCGGTCTCAAGGGATTAT
TCTGAGCAAAGGGACCGGG -> CTGAGCAAAGGGACCGGGA
TCTGGCGTGACTTTGTCTC -> CTGGCGTGACTTTGTCTCA
TCTGTTCAGAGGGCGCCAG -> CTGTTCAGAGGGCGCCAGT
TCTGTTGTGTGGTAGGCAT -> CTGTTGTGTGGTAGGCATT
TCTTAACAGCGCGGATCCA -> CTTAACAGCGCGGATCCAG
TCTTAGAGACTATGTAGTA -> CTTAGAGACTATGTAGTAT
TCTTCACACGATCACTAAC -> CTTCACACGATCACTAACT
TCTTCATAAGGTCCGCCCG -> CTTCATAAGGTCCGCCCGA
TCTTCCATATTGTCCTTCT -> CTTCCATATTGTCCTTCTG
TCTTCTACAAAGGAACGCG -> CTTCTACAAAGGAACGCGC
TCTTGTCCTAAAATTATTC -> CTTGTCCTAAAATTATTCC
TCTTTGCACAAAATCAATT -> CTTTGCACAAAATCAATTC
TCTTTGGCGGGATGACGTC -> CTTTGGCGGGATGACGTCG
TGAACAAATCTCATTTTTA -> GAACAAATCTCATTTTTAA
TGAACAATCGGTTGACCTC -> GAACAATCGGTTGACCTCT
TGAACATGGGGAAGTAACT -> GAACATGGGGAAGTAACTG
TGAACATTACTCTTAGAGA -> GAACATTACTCTTAGAGAC
TGAACCTACGCGATCAACT -> GAACCTACGCGATCAACTT
TGAAGATAGTATTTGCCCG -> GAAGATAGTATTTGCCCGG
TGAAGCAATGCTTGGCGCA -> GAAGCAATGCTTGGCGCAG
TGAAGGCGAAGGTAATGCA -> GAAGGCGAAGGTAATGCAG
TGAATACGGTAAGATGGGC -> GAATACGGTAAGATGGGCC
TGACAAAGCCCAGCCATTT -> GACAAAGCCCAGCCATTTG
TGACATAGTGGTAATGCAG -> GACATAGTGGTAATGCAGG
TGACCTCTAAACGACAAAG -> GACCTCTAAACGACAAAGC
TGACGACTTTCGAATAGTC -> GACGACTTTCGAATAGTCC
TGACGTCGCAGCGAATTAC -> GACGTCGCAGCGAATTACT
TGACTTTGTCTCAACGGCA -> GACTTTGTCTCAACGGCAC
TGAGACCCCGGGTGCAATA -> GAGACCCCGGGTGCAATAC
TGAGAGAAATAATCCACAA -> GAGAGAAATAATCCACAAA
TGAGAGTCATAGACCTCAA -> GAGAGTCATAGACCTCAAA
TGAGAGTGCTGGTTAACTT -> GAGAGTGCTGGTTAACTTG
TGAGATACAGATACCTGGA -> GAGATACAGATACCTGGAT
TGAGATAGTGCCAGCGGAC -> GAGATAGTGCCAGCGGACG
TGAGCAAAGGGACCGGGAT -> GAGCAAAGGGACCGGGATA
TGAGCTTCTACCCGCTAAG -> GAGCTTCTACCCGCTAAGC
TGAGGGCGACGTCACGTAG -> GAGGGCGACGTCACGTAGT
TGAGGTCCTTCGATAGGCC -> GAGGTCCTTCGATAGGCCG
TGAGTAACCGGTAATTATA -> GAGTAACCGGTAATTATAG
TGAGTGGGCCTAGCTCAGA -> GAGTGGGCCTAGCTCAGAT
TGATAATATCCGGGGCGTA -> GATAATATCCGGGGCGTAC
TGATAGAGATGCTTAGCCG -> GATAGAGATGCTTAGCCGA
TGATATCACCTTAACATGC -> GATATCACCTTAACATGCA
TGATCCTCCAAACGGAGCA -> GATCCTCCAAACGGAGCAC
TGATGCGAGGTTTAGGAAG -> GATGCGAGGTTTAGGAAGT
TGCAACTGTCGCAAATTTA -> GCAACTGTCGCAAATTTAG
TGCAATACCCAGGCTCACC -> GCAATACCCAGGCTCACCT
TGCACAAAATCAATTCTGT -> GCACAAAATCAATTCTGTT
TGCACCACCAGTGAGACCC -> GCACCACCAGTGAGACCCC
TGCAGCGCAGAATAACACG -> GCAGCGCAGAATAACACGA
TGCAGGAATGAACAAATCT -> GCAGGAATGAACAAATCTC
TGCAGGAATGAACAATCGG -> GCAGGAATGAACAATCGGT
TGCAGGAATGAACATGGGG -> GCAGGAATGAACATGGGGA
TGCAGGAATGAACATTACT -> GCAGGAATGAACATTACTC
TGCAGGCCATATAACCGTT -> GCAGGCCATATAACCGTTA
TGCATGGGTTATGATAGAG -> GCATGGGTTATGATAGAGA
TGCCAGCGGACGCCATCAG -> GCCAGCGGACGCCATCAGA
TGCCATAGCCTGCTCCCAT -> GCCATAGCCTGCTCCCATG
TGCCCGGAAGCTCCCGGGG -> GCCCGGAAGCTCCCGGGGT
TGCCCTGTAATTAAGTCAC -> GCCCTGTAATTAAGTCACA
TGCCCTTGTTAATCGTCTC -> GCCCTTGTTAATCGTCTCC
TGCCTGGATGAAGGCGAAG -> GCCTGGATGAAGGCGAAGG
TGCCTGGCCTGACATAGTG -> GCCTGGCCTGACATAGTGG
TGCCTGGGGGTCAGGCGTG -> GCCTGGGGGTCAGGCGTGG
TGCCTGGTACGCCCGCTTG -> GCCTGGTACGCCCGCTTGG
TGCGACATAAGGCGGTCAT -> GCGACATAAGGCGGTCATC
TGCGAGACTTTATATTTTG -> GCGAGACTTTATATTTTGC
TGCGAGGTTTAGGAAGTTA -> GCGAGGTTTAGGAAGTTAG
TGCGGACCTGTCGAGCTCC -> GCGGACCTGTCGAGCTCCC
TGCGGCCCCGATGCTTTCA -> GCGGCCCCGATGCTTTCAT
TGCGGCGTCGACCTCTTGT -> GCGGCGTCGACCTCTTGTC
TGCGGTCGCTCTGAGCAAA -> GCGGTCGCTCTGAGCAAAG
TGCTAAATTCTTAACAGCG -> GCTAAATTCTTAACAGCGC
TGCTCATAATCCAGCGCCG -> GCTCATAATCCAGCGCCGC
TGCTCCCATGATCCTCCAA -> GCTCCCATGATCCTCCAAA
TGCTGGTACTAGACGGCGT -> GCTGGTACTAGACGGCGTC
TGCTGGTTAACTTGTTGAC -> GCTGGTTAACTTGTTGACG
TGCTTAGCCGAATGTAATG -> GCTTAGCCGAATGTAATGT
TGCTTGGCGCAGGTATCAG -> GCTTGGCGCAGGTATCAGA
TGCTTGTGTTTGGGGTCCG -> GCTTGTGTTTGGGGTCCGA
TGCTTTCATGGAATGATAA -> GCTTTCATGGAATGATAAT
TGGAAGGCGGACATAAGTC -> GGAAGGCGGACATAAGTCG
TGGAATGATAATATCCGGG -> GGAATGATAATATCCGGGG
TGGAATTCGACTGGGAATA -> GGAATTCGACTGGGAATAG
TGGAGGTGAGAGAAATAAT -> GGAGGTGAGAGAAATAATC
TGGAGGTTACATTCCTTGG -> GGAGGTTACATTCCTTGGT
TGGATACTGTGCTGGTACT -> GGATACTGTGCTGGTACTA
TGGATATCTCATGTAACAG -> GGATATCTCATGTAACAGT
TGGATGAAGGCGAAGGTAA -> GGATGAAGGCGAAGGTAAT
TGGATGTAGCTCGTGTCAA -> GGATGTAGCTCGTGTCAAG
TGGCATCAGCCCTTCTGTT -> GGCATCAGCCCTTCTGTTG
TGGCCTGACATAGTGGTAA -> GGCCTGACATAGTGGTAAT
TGGCGCAGGTATCAGACAA -> GGCGCAGGTATCAGACAAG
TGGCGGGATGACGTCGCAG -> GGCGGGATGACGTCGCAGC
TGGCGTGACTTTGTCTCAA -> GGCGTGACTTTGTCTCAAC
TGGCTGCGGCCCCGATGCT -> GGCTGCGGCCCCGATGCTT
TGGCTGGCATCAGCCCTTC -> GGCTGGCATCAGCCCTTCT
TGGGAAAACTATTCATCCA -> GGGAAAACTATTCATCCAG
TGGGAATAGAAAAATCTTC -> GGGAATAGAAAAATCTTCA
TGGGCCGGAATGCGAGACT -> GGGCCGGAATGCGAGACTT
TGGGCCTAGCTCAGATTCC -> GGGCCTAGCTCAGATTCCA
TGGGGAAGTAACTGAGATA -> GGGGAAGTAACTGAGATAC
TGGGGAATAGCCCAGTACA -> GGGGAATAGCCCAGTACAA
TGGGGCTCCTCCTTGATGC -> GGGGCTCCTCCTTGATGCG
TGGGGGAACCAACCGGACT -> GGGGGAACCAACCGGACTG
TGGGGGTCAGGCGTGGTAA -> GGGGGTCAGGCGTGGTAAT
TGGGGTCCGATGACAAAGC -> GGGGTCCGATGACAAAGCC
TGGGTACCTCGATATGAGG -> GGGTACCTCGATATGAGGT
TGGGTGGAATTCGACTGGG -> GGGTGGAATTCGACTGGGA
TGGGTTATGATAGAGATGC -> GGGTTATGATAGAGATGCT
TGGTAAAATGTCTCAGCGA -> GGTAAAATGTCTCAGCGAG
TGGTAATGCAGGAATGAAC -> GGTAATGCAGGAATGAACA,GGTAATGCAGGAATGAACA,GGTAATGCAGGAATGAACA
TGGTACGCCCGCTTGGTAA -> GGTACGCCCGCTTGGTAAT
TGGTACTAGACGGCGTCAT -> GGTACTAGACGGCGTCATA
TGGTAGGCATTTATCCCGT -> GGTAGGCATTTATCCCGTA
TGGTATGTCAGCTGTATTT -> GGTATGTCAGCTGTATTTA
TGGTCGTAGGCCACTGCCA -> GGTCGTAGGCCACTGCCAT
TGGTTAACTTGTTGACGAC -> GGTTAACTTGTTGACGACT
TGGTTCGTTTAATAGAGGT -> GGTTCGTTTAATAGAGGTA
TGGTTTAGGCGATTTGTTA -> GGTTTAGGCGATTTGTTAC
TGTAACAGTGGTATGTCAG -> GTAACAGTGGTATGTCAGC
TGTAATGTTCAGTATAAGT -> GTAATGTTCAGTATAAGTT
TGTAATTAAGTCACAGAGC -> GTAATTAAGTCACAGAGCC
TGTAGCTCGTGTCAAGTCA -> GTAGCTCGTGTCAAGTCAG
TGTAGTATCACAAGTAGAT -> GTAGTATCACAAGTAGATC
TGTATCACATGTGGGGAAT -> GTATCACATGTGGGGAATA
TGTATTTATATAACACTTG -> GTATTTATATAACACTTGG
TGTCAAGTCAGCGGCAGAC -> GTCAAGTCAGCGGCAGACG
TGTCAGCTGTATTTATATA -> GTCAGCTGTATTTATATAA
TGTCCTAAAATTATTCCAG -> GTCCTAAAATTATTCCAGG
TGTCCTTCTGGCGTGACTT -> GTCCTTCTGGCGTGACTTT
TGTCGAGCTCCCGGGGTGC -> GTCGAGCTCCCGGGGTGCC
TGTCGCAAATTTAGCGAGA -> GTCGCAAATTTAGCGAGAG
TGTCGGCACCAGACGGCTG -> GTCGGCACCAGACGGCTGC
TGTCTCAACGGCACTAAAT -> GTCTCAACGGCACTAAATC
TGTCTCAGCGAGGGTATTC -> GTCTCAGCGAGGGTATTCC
TGTGAACCTACGCGATCAA -> GTGAACCTACGCGATCAAC
TGTGAGAGTCATAGACCTC -> GTGAGAGTCATAGACCTCA
TGTGATATCACCTTAACAT -> GTGATATCACCTTAACATG
TGTGCTGGTACTAGACGGC -> GTGCTGGTACTAGACGGCG
TGTGGCTGGCATCAGCCCT -> GTGGCTGGCATCAGCCCTT
TGTGGGGAATAGCCCAGTA -> GTGGGGAATAGCCCAGTAC
TGTGGTAGGCATTTATCCC -> GTGGTAGGCATTTATCCCG
TGTGTATCACATGTGGGGA -> GTGTATCACATGTGGGGAA
TGTGTGGTAGGCATTTATC -> GTGTGGTAGGCATTTATCC
TGTGTTTGGGGTCCGATGA -> GTGTTTGGGGTCCGATGAC
TGTTAATCGTCTCCAGACG -> GTTAATCGTCTCCAGACGT
TGTTACTTTCCGAGTTATT -> GTTACTTTCCGAGTTATTA
TGTTCAGAGGGCGCCAGTT -> GTTCAGAGGGCGCCAGTTA
TGTTCAGTATAAGTTTATG -> GTTCAGTATAAGTTTATGC
TGTTCCAATTGAGCTTCTA -> GTTCCAATTGAGCTTCTAC
TGTTCGCCCGCAGCTCCCG -> GTTCGCCCGCAGCTCCCGG
TGTTGACGACTTTCGAATA -> GTTGACGACTTTCGAATAG
TGTTGTGTGGTAGGCATTT -> GTTGTGTGGTAGGCATTTA
TGTTTGGGGTCCGATGACA -> GTTTGGGGTCCGATGACAA
TTAAACATTGTGAACCTAC -> TAAACATTGTGAACCTACG
TTAAATGTGGCTGGCATCA -> TAAATGTGGCTGGCATCAG
TTAACAGCGCGGATCCAGG -> TAACAGCGCGGATCCAGGA
TTAACATGCAGGCCATATA -> TAACATGCAGGCCATATAA
TTAACTTGTTGACGACTTT -> TAACTTGTTGACGACTTTC
TTAAGTAGCTCTTTGCACA -> TAAGTAGCTCTTTGCACAA
TTAAGTCACAGAGCCCACC -> TAAGTCACAGAGCCCACCA
TTAATACGAGGGGAAGATG -> TAATACGAGGGGAAGATGA
TTAATAGAGGTACTGGTTT -> TAATAGAGGTACTGGTTTA
TTAATCGTCTCCAGACGTA -> TAATCGTCTCCAGACGTAG
TTACACCGCGTTAATACGA -> TACACCGCGTTAATACGAG
TTACATTCCTTGGTTCGTT -> TACATTCCTTGGTTCGTTT
TTACGCATGGGTGGAATTC -> TACGCATGGGTGGAATTCG
TTACTCTTAGAGACTATGT -> TACTCTTAGAGACTATGTA
TTACTTACACCGCGTTAAT -> TACTTACACCGCGTTAATA
TTACTTTCCGAGTTATTAC -> TACTTTCCGAGTTATTACG
TTAGAGACTATGTAGTATC -> TAGAGACTATGTAGTATCA
TTAGCCCGAGTAATAGTAC -> TAGCCCGAGTAATAGTACA
TTAGCCGAATGTAATGTTC -> TAGCCGAATGTAATGTTCA
TTAGCGAGAGAAGCGGTGT -> TAGCGAGAGAAGCGGTGTC
TTAGGAAGTTAGTGAGAGT -> TAGGAAGTTAGTGAGAGTG
TTAGGCGATTTGTTACTTT -> TAGGCGATTTGTTACTTTC
TTAGTGAGAGTGCTGGTTA -> TAGTGAGAGTGCTGGTTAA
TTATAACGGAACTGGGGGA -> TATAACGGAACTGGGGGAA
TTATACCACTTATAGTACT -> TATACCACTTATAGTACTG
TTATAGGGTCATTGCGGAC -> TATAGGGTCATTGCGGACC
TTATAGGTATTCTTTGGCG -> TATAGGTATTCTTTGGCGG
TTATAGTACTGCGGTCGCT -> TATAGTACTGCGGTCGCTC
TTATATAACACTTGGAGGT -> TATATAACACTTGGAGGTG
TTATATTTTGCTCATAATC -> TATATTTTGCTCATAATCC
TTATCCCGTAAGGTGGTCG -> TATCCCGTAAGGTGGTCGT
TTATGATAGAGATGCTTAG -> TATGATAGAGATGCTTAGC
TTATGCTTGTGTTTGGGGT -> TATGCTTGTGTTTGGGGTC
TTATGGATATCTCATGTAA -> TATGGATATCTCATGTAAC
TTATTACGCATGGGTGGAA -> TATTACGCATGGGTGGAAT
TTATTCCAGGCGGTCTCGG -> TATTCCAGGCGGTCTCGGT
TTCACACGATCACTAACTA -> TCACACGATCACTAACTAG
TTCAGAGGGCGCCAGTTAG -> TCAGAGGGCGCCAGTTAGC
TTCAGTATAAGTTTATGCT -> TCAGTATAAGTTTATGCTT
TTCATAAGGTCCGCCCGAT -> TCATAAGGTCCGCCCGATG
TTCATCCAGGTCCTGCAGC -> TCATCCAGGTCCTGCAGCG
TTCATGGAATGATAATATC -> TCATGGAATGATAATATCC
TTCCAATTGAGCTTCTACC -> TCCAATTGAGCTTCTACCC
TTCCACCTAATCGCAATAG -> TCCACCTAATCGCAATAGG
TTCCAGGATGAATACGGTA -> TCCAGGATGAATACGGTAA
TTCCAGGCGGTCTCGGTCT -> TCCAGGCGGTCTCGGTCTC
TTCCATATTGTCCTTCTGG -> TCCATATTGTCCTTCTGGC
TTCCATGGCTGCGGCCCCG -> TCCATGGCTGCGGCCCCGA
TTCCGAGTTATTACGCATG -> TCCGAGTTATTACGCATGG
TTCCTTGGTTCGTTTAATA -> TCCTTGGTTCGTTTAATAG
TTCGAATAGTCCCGAAATA -> TCGAATAGTCCCGAAATAC
TTCGACTGGGAATAGAAAA -> TCGACTGGGAATAGAAAAA
TTCGATAGGCCGTGAGTGG -> TCGATAGGCCGTGAGTGGG
TTCGCCCGCAGCTCCCGGG -> TCGCCCGCAGCTCCCGGGG
TTCGTTGAGTAACCGGTAA -> TCGTTGAGTAACCGGTAAT
TTCGTTGTGAGAGTCATAG -> TCGTTGTGAGAGTCATAGA
TTCGTTTAATAGAGGTACT -> TCGTTTAATAGAGGTACTG
TTCTACAAAGGAACGCGCG -> TCTACAAAGGAACGCGCGC
TTCTACCCGCTAAGCACTG -> TCTACCCGCTAAGCACTGT
TTCTGGCGTGACTTTGTCT -> TCTGGCGTGACTTTGTCTC
TTCTGTTCAGAGGGCGCCA -> TCTGTTCAGAGGGCGCCAG
TTCTGTTGTGTGGTAGGCA -> TCTGTTGTGTGGTAGGCAT
TTCTTAACAGCGCGGATCC -> TCTTAACAGCGCGGATCCA
TTCTTTGGCGGGATGACGT -> TCTTTGGCGGGATGACGTC
TTGACCTCTAAACGACAAA -> TGACCTCTAAACGACAAAG
TTGACGACTTTCGAATAGT -> TGACGACTTTCGAATAGTC
TTGAGCTTCTACCCGCTAA -> TGAGCTTCTACCCGCTAAG
TTGAGTAACCGGTAATTAT -> TGAGTAACCGGTAATTATA
TTGATGCGAGGTTTAGGAA -> TGATGCGAGGTTTAGGAAG
TTGCAACTGTCGCAAATTT -> TGCAACTGTCGCAAATTTA
TTGCACAAAATCAATTCTG -> TGCACAAAATCAATTCTGT
TTGCCCGGAAGCTCCCGGG -> TGCCCGGAAGCTCCCGGGG
TTGCCCTTGTTAATCGTCT -> TGCCCTTGTTAATCGTCTC
TTGCGGACCTGTCGAGCTC -> TGCGGACCTGTCGAGCTCC
TTGCTCATAATCCAGCGCC -> TGCTCATAATCCAGCGCCG
TTGGAGGTGAGAGAAATAA -> TGGAGGTGAGAGAAATAAT
TTGGATGTAGCTCGTGTCA -> TGGATGTAGCTCGTGTCAA
TTGGCGCAGGTATCAGACA -> TGGCGCAGGTATCAGACAA
TTGGCGGGATGACGTCGCA -> TGGCGGGATGACGTCGCAG
TTGGGGTCCGATGACAAAG -> TGGGGTCCGATGACAAAGC
TTGGGTACCTCGATATGAG -> TGGGTACCTCGATATGAGG
TTGGTAAAATGTCTCAGCG -> TGGTAAAATGTCTCAGCGA
TTGGTAATGCAGGAATGAA -> TGGTAATGCAGGAATGAAC
TTGGTTCGTTTAATAGAGG -> TGGTTCGTTTAATAGAGGT
TTGTCCTAAAATTATTCCA -> TGTCCTAAAATTATTCCAG
TTGTCCTTCTGGCGTGACT -> TGTCCTTCTGGCGTGACTT
TTGTCTCAACGGCACTAAA -> TGTCTCAACGGCACTAAAT
TTGTGAACCTACGCGATCA -> TGTGAACCTACGCGATCAA
TTGTGAGAGTCATAGACCT -> TGTGAGAGTCATAGACCTC
TTGTGTGGTAGGCATTTAT -> TGTGTGGTAGGCATTTATC
TTGTGTTTGGGGTCCGATG -> TGTGTTTGGGGTCCGATGA
TTGTTAATCGTCTCCAGAC -> TGTTAATCGTCTCCAGACG
TTGTTACTTTCCGAGTTAT -> TGTTACTTTCCGAGTTATT
TTGTTCCAATTGAGCTTCT -> TGTTCCAATTGAGCTTCTA
TTGTTGACGACTTTCGAAT -> TGTTGACGACTTTCGAATA
TTTAAACATTGTGAACCTA -> TTAAACATTGTGAACCTAC
TTTAATAGAGGTACTGGTT -> TTAATAGAGGTACTGGTTT
TTTAGCGAGAGAAGCGGTG -> TTAGCGAGAGAAGCGGTGT
TTTAGGAAGTTAGTGAGAG -> TTAGGAAGTTAGTGAGAGT
TTTAGGCGATTTGTTACTT -> TTAGGCGATTTGTTACTTT
TTTATATAACACTTGGAGG -> TTATATAACACTTGGAGGT
TTTATATTTTGCTCATAAT -> TTATATTTTGCTCATAATC
TTTATCCCGTAAGGTGGTC -> TTATCCCGTAAGGTGGTCG
TTTATGCTTGTGTTTGGGG -> TTATGCTTGTGTTTGGGGT
TTTCATGGAATGATAATAT -> TTCATGGAATGATAATATC
TTTCCACCTAATCGCAATA -> TTCCACCTAATCGCAATAG
TTTCCGAGTTATTACGCAT -> TTCCGAGTTATTACGCATG
TTTCGAATAGTCCCGAAAT -> TTCGAATAGTCCCGAAATA
TTTGCACAAAATCAATTCT -> TTGCACAAAATCAATTCTG
TTTGCCCGGAAGCTCCCGG -> TTGCCCGGAAGCTCCCGGG
TTTGCTCATAATCCAGCGC -> TTGCTCATAATCCAGCGCC
TTTGGCGGGATGACGTCGC -> TTGGCGGGATGACGTCGCA
TTTGGGGTCCGATGACAAA -> TTGGGGTCCGATGACAAAG
TTTGGGTACCTCGATATGA -> TTGGGTACCTCGATATGAG
TTTGGTAAAATGTCTCAGC -> TTGGTAAAATGTCTCAGCG
TTTGTCTCAACGGCACTAA -> TTGTCTCAACGGCACTAAA
TTTGTTACTTTCCGAGTTA -> TTGTTACTTTCCGAGTTAT
TTTTAAACATTGTGAACCT -> TTTAAACATTGTGAACCTA
TTTTGCTCATAATCCAGCG -> TTTGCTCATAATCCAGCGC
TTTTTAAACATTGTGAACC -> TTTTAAACATTGTGAACCT
